head_node	edge_relation 	head_node edge_relation /r/Antonymhead ofnode edge
armenian	/r/IsA 	armenian /r/IsAoccupation
persian	/r/IsA 	persian /r/IsAtype of organism with an anatomical entity
american	/r/IsA 	american /r/IsAfictional entity
filipino	/r/IsA 	filipino /r/IsAmusic term
english	/r/IsA 	english /r/IsAhuman being
norwegian	/r/IsA 	norwegian /r/IsAvocaloid
dutch	/r/IsA 	dutch /r/IsAeconomic concept
israeli	/r/IsA 	israeli /r/IsAeconomic concept
nigerian	/r/IsA 	nigerian /r/IsAseafood
ethiopia	/r/IsA 	ethiopia /r/IsAhealth problem
europe	/r/IsA 	europe /r/IsAregion of the planet
european	/r/IsA 	european /r/IsAcivilian
russian	/r/IsA 	russian /r/IsAmilitary officer
ukraine	/r/IsA 	ukraine /r/IsApolitical region
sudan	/r/IsA 	sudan /r/IsAscholarly article
afghanistan	/r/IsA 	afghanistan /r/IsAfictional country
iraq	/r/IsA 	iraq /r/IsAfictional profession
yemen	/r/IsA 	yemen /r/IsAoccupation
ukrainian	/r/IsA 	ukrainian /r/IsAposition
russia	/r/IsA 	russia /r/IsAgeography term
italy	/r/IsA 	italy /r/IsAmeeting
somali	/r/IsA 	somali /r/IsAfungus
iran	/r/IsA 	iran /r/IsAnaval historian
afghan	/r/IsA 	afghan /r/IsAfictional human
indian	/r/IsA 	indian /r/IsAartificial figure
italian	/r/IsA 	italian /r/IsAname
australian	/r/IsA 	australian /r/IsAoccupation
spanish	/r/IsA 	spanish /r/IsAcultural appropriation
guatemalan	/r/IsA 	guatemalan /r/IsAfictional country
hispanic	/r/IsA 	hispanic /r/IsAsocial issue
venezuela	/r/IsA 	venezuela /r/IsAartistic theme
sudanese	/r/IsA 	sudanese /r/IsAsudanese
oman	/r/IsA 	oman /r/IsAoccupation
finnish	/r/IsA 	finnish /r/IsAfinnish
swedish	/r/IsA 	swedish /r/IsAtype of sport
venezuelan	/r/IsA 	venezuelan /r/IsAeducator
puerto rican	/r/IsA 	puerto rican /r/IsAmusical group
ghanaian	/r/IsA 	ghanaian /r/IsAmusical profession
moroccan	/r/IsA 	moroccan /r/IsApsychology term
somalia	/r/IsA 	somalia /r/IsAacademic discipline
saudi arabian	/r/IsA 	saudi arabian /r/IsAacademic discipline
syria	/r/IsA 	syria /r/IsAsemi-structural component
chinese	/r/IsA 	chinese /r/IsAfictional organism
pakistani	/r/IsA 	pakistani /r/IsAtribe
china	/r/IsA 	china /r/IsAcultural figure
india	/r/IsA 	india /r/IsAindigenous ethnic group
irish	/r/IsA 	irish /r/IsAmixed martial arts video game
britain	/r/IsA 	britain /r/IsAfood ingredient
france	/r/IsA 	france /r/IsAcultural heritage site
greece	/r/IsA 	greece /r/IsAregion of the globe
scotland	/r/IsA 	scotland /r/IsAmilitary district
mexican	/r/IsA 	mexican /r/IsAgeographical object
paraguayan	/r/IsA 	paraguayan /r/IsAconcerto
brazil	/r/IsA 	brazil /r/IsAconcerto
african	/r/IsA 	african /r/IsAcultural group
eritrean	/r/IsA 	eritrean /r/IsAscholarly article
sierra leonean	/r/IsA 	sierra leonean /r/IsAlean
africa	/r/IsA 	africa /r/IsAeconomic concept
jordan	/r/IsA 	jordan /r/IsAgiant dog
indonesia	/r/IsA 	indonesia /r/IsAindonesian
vietnam	/r/IsA 	vietnam /r/IsAeconomic concept
pakistan	/r/IsA 	pakistan /r/IsAoccupation
german	/r/IsA 	german /r/IsAoccupation
romania	/r/IsA 	romania /r/IsAreligious genre
brazilian	/r/IsA 	brazilian /r/IsAlegal profession
ecuadorian	/r/IsA 	ecuadorian /r/IsAoccupation
mexico	/r/IsA 	mexico /r/IsAcousin
puerto rico	/r/IsA 	puerto rico /r/IsAcultural heritage site
kenyan	/r/IsA 	kenyan /r/IsAfictional material
liberian	/r/IsA 	liberian /r/IsAhuman
cameroonian	/r/IsA 	cameroonian /r/IsAarchaeological find
african americans	/r/IsA 	african americans /r/IsAmuslim
kenya	/r/IsA 	kenya /r/IsAmusical composition
liberia	/r/IsA 	liberia /r/IsAcountry
sierra leon	/r/IsA 	sierra leon /r/IsAnaut
qatari	/r/IsA 	qatari /r/IsApolitical work
syrian	/r/IsA 	syrian /r/IsAtype of wood
arab	/r/IsA 	arab /r/IsAsports discipline
saudi arabia	/r/IsA 	saudi arabia /r/IsAartistic theme
lebanon	/r/IsA 	lebanon /r/IsAartificial entity
indonesian	/r/IsA 	indonesian /r/IsAindigenous human
french	/r/IsA 	french /r/IsAfrench
norwegian	/r/IsA 	norwegian /r/IsAmusical profession
south africa	/r/IsA 	south africa /r/IsAsouth african entity
jordanian	/r/IsA 	jordanian /r/IsAhuman character
korea	/r/IsA 	korea /r/IsAregion
singapore	/r/IsA 	singapore /r/IsAgeographical object
romanian	/r/IsA 	romanian /r/IsAsymbol
crimean	/r/IsA 	crimean /r/IsAoccupation
native american	/r/IsA 	native american /r/IsAhumanoid
germany	/r/IsA 	germany /r/IsAmeeting
ireland	/r/IsA 	ireland /r/IsAhistorical region
ecuador	/r/IsA 	ecuador /r/IsAoccupation
morocco	/r/IsA 	morocco /r/IsAmusic genre
omani	/r/IsA 	omani /r/IsAhuman-machine interface component
iranian	/r/IsA 	iranian /r/IsAscholarly article
iraqi	/r/IsA 	iraqi /r/IsAnatural element
qatar	/r/IsA 	qatar /r/IsAnarrative element
turkey	/r/IsA 	turkey /r/IsAfood ingredient
vietnamese	/r/IsA 	vietnamese /r/IsAvietnamese-aviation warfare
nepali	/r/IsA 	nepali /r/IsAfictional location
laos	/r/IsA 	laos /r/IsAgroup of organisms known by one particular common name
bangladesh	/r/IsA 	bangladesh /r/IsAanimal-flesse
british	/r/IsA 	british /r/IsAcouples
polish	/r/IsA 	polish /r/IsAphilosophical concept
greek	/r/IsA 	greek /r/IsAgroup of living things
scottish	/r/IsA 	scottish /r/IsAtype of wood
bolivian	/r/IsA 	bolivian /r/IsAfictional human
guatemala	/r/IsA 	guatemala /r/IsAprocess
ghana	/r/IsA 	ghana /r/IsAhistorical material
cameroon	/r/IsA 	cameroon /r/IsAgeographical object
japanese	/r/IsA 	japanese /r/IsAmusical group
taiwanese	/r/IsA 	taiwanese /r/IsAanatomical territorial entity
bengali	/r/IsA 	bengali /r/IsAartistic concept
nepal	/r/IsA 	nepal /r/IsAnatural resource
albanian	/r/IsA 	albanian /r/IsAcabinet
albania	/r/IsA 	albania /r/IsAbanned
columbian	/r/IsA 	columbian /r/IsAgeographical object
peruvian	/r/IsA 	peruvian /r/IsAspecialty
argentian	/r/IsA 	argentian /r/IsAsociological term
spain	/r/IsA 	spain /r/IsAprocess
paraguay	/r/IsA 	paraguay /r/IsAadministration
ethiopian	/r/IsA 	ethiopian /r/IsAanimal type
egyptian	/r/IsA 	egyptian /r/IsAacademic title
persian people	/r/IsA 	persian people /r/IsApersonage
sweden	/r/IsA 	sweden /r/IsAnorthernmost country
crimea	/r/IsA 	crimea /r/IsAcousin
portuguese	/r/IsA 	portuguese /r/IsAportrait
argentina	/r/IsA 	argentina /r/IsApara, geology terminology
chile	/r/IsA 	chile /r/IsAfood ingredient
cape verdean	/r/IsA 	cape verdean /r/IsAart material
turkish	/r/IsA 	turkish /r/IsAturkish ideology
yemeni	/r/IsA 	yemeni /r/IsAsynthetic name
taiwan	/r/IsA 	taiwan /r/IsAgroup of organisms known by one particular common name
austrian	/r/IsA 	austrian /r/IsAsemiconductor manufacturer
white people	/r/IsA 	white people /r/IsAethnic group
finland	/r/IsA 	finland /r/IsAeconomic concept
australia	/r/IsA 	australia /r/IsAcrest
south african	/r/IsA 	south african /r/IsAanatomical line
eriteria	/r/IsA 	eriteria /r/IsAeconomic concept
egypt	/r/IsA 	egypt /r/IsAtertiary planet
korean	/r/IsA 	korean /r/IsAclothing item
dutch people	/r/IsA 	dutch people /r/IsAoccupation
peru	/r/IsA 	peru /r/IsAoccupation
poland	/r/IsA 	poland /r/IsAeconomic concept
chilean	/r/IsA 	chilean /r/IsAgland
columbia	/r/IsA 	columbia /r/IsAsocial group
bolivia	/r/IsA 	bolivia /r/IsAeconomic indicator
laotian	/r/IsA 	laotian /r/IsAoccupation
lebanese	/r/IsA 	lebanese /r/IsAgroup of organisms known by one particular common name
japan	/r/IsA 	japan /r/IsAcandy
norway	/r/IsA 	norway /r/IsAsubmarine component
cape verde	/r/IsA 	cape verde /r/IsAvocal music
portugal	/r/IsA 	portugal /r/IsAgeographical object
austria	/r/IsA 	austria /r/IsAbend
singaporean	/r/IsA 	singaporean /r/IsAcivil society organisation
netherlands	/r/IsA 	netherlands /r/IsAgeographic object
she	/r/IsA 	she /r/IsAfigure skating rink
he	/r/IsA 	he /r/IsAdevice
hers	/r/IsA 	hers /r/IsAsocial worker
him	/r/IsA 	him /r/IsAfictional character
her	/r/IsA 	her /r/IsAhuman entity
herself	/r/IsA 	herself /r/IsAoccupation
himself	/r/IsA 	himself /r/IsAperson, entity, concept, or process
his	/r/IsA 	his /r/IsAposition
woman	/r/IsA 	woman /r/IsAwomen\'s rights activist
man	/r/IsA 	man /r/IsAhuman character
female	/r/IsA 	female /r/IsAmale
male	/r/IsA 	male /r/IsAfictional human
lady	/r/IsA 	lady /r/IsAhuman figure
gentleman	/r/IsA 	gentleman /r/IsAoccupation
ladies	/r/IsA 	ladies /r/IsAhuman being
gentlemen	/r/IsA 	gentlemen /r/IsAmuseum worker
girl	/r/IsA 	girl /r/IsAmale human
boy	/r/IsA 	boy /r/IsAoccupation
sir	/r/IsA 	sir /r/IsAname
ma am	/r/IsA 	ma am /r/IsAname of an entity
mother	/r/IsA 	mother /r/IsAoccupation
father	/r/IsA 	father /r/IsAfictional human
stepmother	/r/IsA 	stepmother /r/IsAfemale human
stepfather	/r/IsA 	stepfather /r/IsAchildcare
daughter	/r/IsA 	daughter /r/IsAposition
son	/r/IsA 	son /r/IsAcharacter
sister	/r/IsA 	sister /r/IsAadolescent
brother	/r/IsA 	brother /r/IsAcoupling
grandmother	/r/IsA 	grandmother /r/IsAgrandchild
grandfather	/r/IsA 	grandfather /r/IsAgrandchild
mommy	/r/IsA 	mommy /r/IsAperson of the character
daddy	/r/IsA 	daddy /r/IsAfictional entity
wife	/r/IsA 	wife /r/IsAhuman figure
husband	/r/IsA 	husband /r/IsAname
bride	/r/IsA 	bride /r/IsAbride
groom	/r/IsA 	groom /r/IsAanimal species
girlfriend	/r/IsA 	girlfriend /r/IsAcousin
boyfriend	/r/IsA 	boyfriend /r/IsAconsception
schoolgirl	/r/IsA 	schoolgirl /r/IsAfilm personality
schoolboy	/r/IsA 	schoolboy /r/IsAfictional human
sharia	/r/IsA 	sharia /r/IsAreligious concept
jihad	/r/IsA 	jihad /r/IsAjihad
christian	/r/IsA 	christian /r/IsAdeity
muslim	/r/IsA 	muslim /r/IsAmusical profession
islam	/r/IsA 	islam /r/IsAeconomic concept
hindu	/r/IsA 	hindu /r/IsAcultural identity
mohammed	/r/IsA 	mohammed /r/IsAoccupation
church	/r/IsA 	church /r/IsAmilitary unit type-size class
quran	/r/IsA 	quran /r/IsAreligious figure
bible	/r/IsA 	bible /r/IsAbiblical figure
brahmin	/r/IsA 	brahmin /r/IsAcharacter type
holy trinity	/r/IsA 	holy trinity /r/IsAreligious concept
barber	/r/IsA 	barber /r/IsAbarber
coach	/r/IsA 	coach /r/IsAtool
businessperson	/r/IsA 	businessperson /r/IsAjob type
football player	/r/IsA 	football player /r/IsAoccupation
construction worker	/r/IsA 	construction worker /r/IsAconstruction worker
manager	/r/IsA 	manager /r/IsAidentifier
ceo	/r/IsA 	ceo /r/IsAmilitary unit type-size class
accountant	/r/IsA 	accountant /r/IsAaccountant
commander	/r/IsA 	commander /r/IsAposition
firefighter	/r/IsA 	firefighter /r/IsAmilitary rank
mover	/r/IsA 	mover /r/IsAmilitary rank
software developer	/r/IsA 	software developer /r/IsAsoftware developer
guard	/r/IsA 	guard /r/IsAoccupation
baker	/r/IsA 	baker /r/IsAfood ingredient
doctor	/r/IsA 	doctor /r/IsAoccupation
athlete	/r/IsA 	athlete /r/IsAaccident
artist	/r/IsA 	artist /r/IsAart term
dancer	/r/IsA 	dancer /r/IsAoccupation
mathematician	/r/IsA 	mathematician /r/IsAtechnical person
janitor	/r/IsA 	janitor /r/IsAtennis character
carpenter	/r/IsA 	carpenter /r/IsAarchitectural structure
mechanic	/r/IsA 	mechanic /r/IsAposition
actor	/r/IsA 	actor /r/IsAoccupation
handyman	/r/IsA 	handyman /r/IsAmeester
musician	/r/IsA 	musician /r/IsAmusical profession
detective	/r/IsA 	detective /r/IsAcriminal
politician	/r/IsA 	politician /r/IsApolitical candidate
entrepreneur	/r/IsA 	entrepreneur /r/IsAfictional human
model	/r/IsA 	model /r/IsAtextile product
opera singer	/r/IsA 	opera singer /r/IsAoccupation
chief	/r/IsA 	chief /r/IsAoccupation
lawyer	/r/IsA 	lawyer /r/IsAoccupation
farmer	/r/IsA 	farmer /r/IsAgeographic title
writer	/r/IsA 	writer /r/IsAfilm character
librarian	/r/IsA 	librarian /r/IsAoccupation
army	/r/IsA 	army /r/IsAoccupation
real estate developer	/r/IsA 	real estate developer /r/IsAposition
broker	/r/IsA 	broker /r/IsAbroker
scientist	/r/IsA 	scientist /r/IsAscientific researcher
butcher	/r/IsA 	butcher /r/IsAoccupation
electrician	/r/IsA 	electrician /r/IsAoccupation
prosecutor	/r/IsA 	prosecutor /r/IsAposition
banker	/r/IsA 	banker /r/IsAoccupation
cook	/r/IsA 	cook /r/IsAconventional weapon
hairdresser	/r/IsA 	hairdresser /r/IsAsnowflake
prisoner	/r/IsA 	prisoner /r/IsAperson
plumber	/r/IsA 	plumber /r/IsAposition
attorney	/r/IsA 	attorney /r/IsAlegal associate
boxer	/r/IsA 	boxer /r/IsAposition
chess player	/r/IsA 	chess player /r/IsAcombat trainer
priest	/r/IsA 	priest /r/IsAoccupation
swimmer	/r/IsA 	swimmer /r/IsAoccupation
tennis player	/r/IsA 	tennis player /r/IsAfictional character
supervisor	/r/IsA 	supervisor /r/IsAsupervisor
attendant	/r/IsA 	attendant /r/IsAperson
housekeeper	/r/IsA 	housekeeper /r/IsAoccupation
maid	/r/IsA 	maid /r/IsAservant
producer	/r/IsA 	producer /r/IsAposition
researcher	/r/IsA 	researcher /r/IsAscholarly article
midwife	/r/IsA 	midwife /r/IsAfictional human
judge	/r/IsA 	judge /r/IsAposition
umpire	/r/IsA 	umpire /r/IsAmachine element
bartender	/r/IsA 	bartender /r/IsAoccupation
economist	/r/IsA 	economist /r/IsAoccupation
physicist	/r/IsA 	physicist /r/IsAspecialist
psychologist	/r/IsA 	psychologist /r/IsApsychologist
theologian	/r/IsA 	theologian /r/IsAoccupation
salesperson	/r/IsA 	salesperson /r/IsAperson
physician	/r/IsA 	physician /r/IsAoccupation
sheriff	/r/IsA 	sheriff /r/IsAposition
cashier	/r/IsA 	cashier /r/IsAaccount
assistant	/r/IsA 	assistant /r/IsAposition
receptionist	/r/IsA 	receptionist /r/IsAfilm crew member
editor	/r/IsA 	editor /r/IsAoccupant
engineer	/r/IsA 	engineer /r/IsAengine builder
comedian	/r/IsA 	comedian /r/IsApublic figure
painter	/r/IsA 	painter /r/IsAoccupation
civil servant	/r/IsA 	civil servant /r/IsAcivil service
diplomat	/r/IsA 	diplomat /r/IsAposition
guitarist	/r/IsA 	guitarist /r/IsAoccupation
linguist	/r/IsA 	linguist /r/IsAeducator
poet	/r/IsA 	poet /r/IsAoccupation
laborer	/r/IsA 	laborer /r/IsAlaborer
teacher	/r/IsA 	teacher /r/IsAoccupation
delivery man	/r/IsA 	delivery man /r/IsAmedical technician
realtor	/r/IsA 	realtor /r/IsAoccupation
pilot	/r/IsA 	pilot /r/IsAmanual operator
professor	/r/IsA 	professor /r/IsAposition
chemist	/r/IsA 	chemist /r/IsAarchitectural element
historian	/r/IsA 	historian /r/IsAhistorian
pensioner	/r/IsA 	pensioner /r/IsApensioner
performing artist	/r/IsA 	performing artist /r/IsAtheatrical profession
singer	/r/IsA 	singer /r/IsAposition
secretary	/r/IsA 	secretary /r/IsAconsultant
auditor	/r/IsA 	auditor /r/IsAadvisor
counselor	/r/IsA 	counselor /r/IsAoccupation
designer	/r/IsA 	designer /r/IsAoccupation
soldier	/r/IsA 	soldier /r/IsAoccupation
journalist	/r/IsA 	journalist /r/IsAjournalist
dentist	/r/IsA 	dentist /r/IsAoccupation
analyst	/r/IsA 	analyst /r/IsAanalytic term
nurse	/r/IsA 	nurse /r/IsAhealth professional
tailor	/r/IsA 	tailor /r/IsAposition
waiter	/r/IsA 	waiter /r/IsAoccupation
author	/r/IsA 	author /r/IsAtitle
architect	/r/IsA 	architect /r/IsAoccupation
academic	/r/IsA 	academic /r/IsAacademic
director	/r/IsA 	director /r/IsAposition
illustrator	/r/IsA 	illustrator /r/IsAartistic profession
clerk	/r/IsA 	clerk /r/IsASynonym
policeman	/r/IsA 	policeman /r/IsAposition
chef	/r/IsA 	chef /r/IsAoccupation
photographer	/r/IsA 	photographer /r/IsAphotography profession
drawer	/r/IsA 	drawer /r/IsAhand
cleaner	/r/IsA 	cleaner /r/IsAoccupation
pharmacist	/r/IsA 	pharmacist /r/IsAoccupation
pianist	/r/IsA 	pianist /r/IsAposition
composer	/r/IsA 	composer /r/IsAship element
handball player	/r/IsA 	handball player /r/IsAtool
sociologist	/r/IsA 	sociologist /r/IsAoccupation
african american	/r/RelatedTo 	african american /r/RelatedToindigenous country
armenian	/r/RelatedTo 	armenian /r/RelatedTodilemma
persian	/r/RelatedTo 	persian /r/RelatedTobirth control
american	/r/RelatedTo 	american /r/RelatedToamerican
filipino	/r/RelatedTo 	filipino /r/RelatedTofilipino sauce
english	/r/RelatedTo 	english /r/RelatedTomilitary rank
norwegian	/r/RelatedTo 	norwegian /r/RelatedTonoise
dutch	/r/RelatedTo 	dutch /r/RelatedTodutch
israeli	/r/RelatedTo 	israeli /r/RelatedTopolitical leader
nigerian	/r/RelatedTo 	nigerian /r/RelatedTonigga
ethiopia	/r/RelatedTo 	ethiopia /r/RelatedTocannibal
europe	/r/RelatedTo 	europe /r/RelatedTocricket
european	/r/RelatedTo 	european /r/RelatedToeuropean republic
russian	/r/RelatedTo 	russian /r/RelatedTobondage
ukraine	/r/RelatedTo 	ukraine /r/RelatedTocotton
sudan	/r/RelatedTo 	sudan /r/RelatedToprairie
afghanistan	/r/RelatedTo 	afghanistan /r/RelatedToflooded country
iraq	/r/RelatedTo 	iraq /r/RelatedTofood ingredient
yemen	/r/RelatedTo 	yemen /r/RelatedTowomen\'s sports
ukrainian	/r/RelatedTo 	ukrainian /r/RelatedTobibliography
russia	/r/RelatedTo 	russia /r/RelatedToscholarly article
italy	/r/RelatedTo 	italy /r/RelatedTomusical composition
somali	/r/RelatedTo 	somali /r/RelatedToyouth
iran	/r/RelatedTo 	iran /r/RelatedToanimal culture
afghan	/r/RelatedTo 	afghan /r/RelatedTocoupling
indian	/r/RelatedTo 	indian /r/RelatedToindian country
italian	/r/RelatedTo 	italian /r/RelatedTogarden building
australian	/r/RelatedTo 	australian /r/RelatedToposterior terminal of free nasal bone
spanish	/r/RelatedTo 	spanish /r/RelatedTospeaker
guatemalan	/r/RelatedTo 	guatemalan /r/RelatedToguarâguarantee
hispanic	/r/RelatedTo 	hispanic /r/RelatedTosyndrome
venezuela	/r/RelatedTo 	venezuela /r/RelatedTofood and drink with cheese
sudanese	/r/RelatedTo 	sudanese /r/RelatedTosmog
oman	/r/RelatedTo 	oman /r/RelatedTooccupation
finnish	/r/RelatedTo 	finnish /r/RelatedTofolk
swedish	/r/RelatedTo 	swedish /r/RelatedTochoreography
venezuelan	/r/RelatedTo 	venezuelan /r/RelatedToscholarly article
puerto rican	/r/RelatedTo 	puerto rican /r/RelatedTopiano duo
ghanaian	/r/RelatedTo 	ghanaian /r/RelatedTogulfic sugar substitute
moroccan	/r/RelatedTo 	moroccan /r/RelatedTonatural hair
somalia	/r/RelatedTo 	somalia /r/RelatedTosharitanical region
saudi arabian	/r/RelatedTo 	saudi arabian /r/RelatedTomusic genre
syria	/r/RelatedTo 	syria /r/RelatedTosyrian language
chinese	/r/RelatedTo 	chinese /r/RelatedTochinese food
pakistani	/r/RelatedTo 	pakistani /r/RelatedTobarbarbaric language
china	/r/RelatedTo 	china /r/RelatedToheritage site
india	/r/RelatedTo 	india /r/RelatedToindigenous language
irish	/r/RelatedTo 	irish /r/RelatedToanimal rights movement
britain	/r/RelatedTo 	britain /r/RelatedTochicken dish
france	/r/RelatedTo 	france /r/RelatedTolegal relationship
greece	/r/RelatedTo 	greece /r/RelatedTogeographical region
scotland	/r/RelatedTo 	scotland /r/RelatedToanatomical zone
mexican	/r/RelatedTo 	mexican /r/RelatedTocinnamon syrup
paraguayan	/r/RelatedTo 	paraguayan /r/RelatedToparaguay
brazil	/r/RelatedTo 	brazil /r/RelatedTocolor
african	/r/RelatedTo 	african /r/RelatedTofelony
eritrean	/r/RelatedTo 	eritrean /r/RelatedToartistic theme
sierra leonean	/r/RelatedTo 	sierra leonean /r/RelatedToleonesa
africa	/r/RelatedTo 	africa /r/RelatedToafrican country
jordan	/r/RelatedTo 	jordan /r/RelatedToreligious book
indonesia	/r/RelatedTo 	indonesia /r/RelatedToindonesian language
vietnam	/r/RelatedTo 	vietnam /r/RelatedTodietary supplement
pakistan	/r/RelatedTo 	pakistan /r/RelatedTosoutheast
german	/r/RelatedTo 	german /r/RelatedTofarm-raised farmer
romania	/r/RelatedTo 	romania /r/RelatedToromantic fiction
brazilian	/r/RelatedTo 	brazilian /r/RelatedTodrama television series
ecuadorian	/r/RelatedTo 	ecuadorian /r/RelatedToexclusion
mexico	/r/RelatedTo 	mexico /r/RelatedTomexy
puerto rico	/r/RelatedTo 	puerto rico /r/RelatedTopiano music
kenyan	/r/RelatedTo 	kenyan /r/RelatedTonomenclature
liberian	/r/RelatedTo 	liberian /r/RelatedToposition
cameroonian	/r/RelatedTo 	cameroonian /r/RelatedTobenevolent entity
african americans	/r/RelatedTo 	african americans /r/RelatedTogroup of fictional characters
kenya	/r/RelatedTo 	kenya /r/RelatedTokem /r/scholarly article
liberia	/r/RelatedTo 	liberia /r/RelatedTolibertarian nationalism
sierra leon	/r/RelatedTo 	sierra leon /r/RelatedTosierra
qatari	/r/RelatedTo 	qatari /r/RelatedToquasi-symbol
syrian	/r/RelatedTo 	syrian /r/RelatedTosyrian-run network
arab	/r/RelatedTo 	arab /r/RelatedTomusical theater genre
saudi arabia	/r/RelatedTo 	saudi arabia /r/RelatedTosaudi arabia
lebanon	/r/RelatedTo 	lebanon /r/RelatedTolebanon juice
indonesian	/r/RelatedTo 	indonesian /r/RelatedToindonesian language
french	/r/RelatedTo 	french /r/RelatedTogarden decoration
norwegian	/r/RelatedTo 	norwegian /r/RelatedTovoting system
south africa	/r/RelatedTo 	south africa /r/RelatedTosouth pole
jordanian	/r/RelatedTo 	jordanian /r/RelatedTojordanian dress
korea	/r/RelatedTo 	korea /r/RelatedTopoultry breeding
singapore	/r/RelatedTo 	singapore /r/RelatedTosingapore region
romanian	/r/RelatedTo 	romanian /r/RelatedTogoth
crimean	/r/RelatedTo 	crimean /r/RelatedTomurder
native american	/r/RelatedTo 	native american /r/RelatedTocitizen
germany	/r/RelatedTo 	germany /r/RelatedTogarden building
ireland	/r/RelatedTo 	ireland /r/RelatedToland system and territorial entity
ecuador	/r/RelatedTo 	ecuador /r/RelatedToceremonial church
morocco	/r/RelatedTo 	morocco /r/RelatedTopsychology terminology
omani	/r/RelatedTo 	omani /r/RelatedTofisher
iranian	/r/RelatedTo 	iranian /r/RelatedTomixed-sex relationship
iraqi	/r/RelatedTo 	iraqi /r/RelatedTomarshal training
qatar	/r/RelatedTo 	qatar /r/RelatedTosports attire
turkey	/r/RelatedTo 	turkey /r/RelatedToshrimp pie
vietnamese	/r/RelatedTo 	vietnamese /r/RelatedToaviation engineer
nepali	/r/RelatedTo 	nepali /r/RelatedTonon-nepal
laos	/r/RelatedTo 	laos /r/RelatedTomotorcycle sport
bangladesh	/r/RelatedTo 	bangladesh /r/RelatedTobronze
british	/r/RelatedTo 	british /r/RelatedTobritish union
polish	/r/RelatedTo 	polish /r/RelatedToproper terminology
greek	/r/RelatedTo 	greek /r/RelatedTogrammar
scottish	/r/RelatedTo 	scottish /r/RelatedTocrestal
bolivian	/r/RelatedTo 	bolivian /r/RelatedToalpine
guatemala	/r/RelatedTo 	guatemala /r/RelatedTochess terminology
ghana	/r/RelatedTo 	ghana /r/RelatedTobrown rice
cameroon	/r/RelatedTo 	cameroon /r/RelatedTocameroon-like geographic object
japanese	/r/RelatedTo 	japanese /r/RelatedTogroup of organisms known by one particular common name
taiwanese	/r/RelatedTo 	taiwanese /r/RelatedTotaiwanese
bengali	/r/RelatedTo 	bengali /r/RelatedTobdi
nepal	/r/RelatedTo 	nepal /r/RelatedTosemiconductor processing industry
albanian	/r/RelatedTo 	albanian /r/RelatedTobiblical occupation
albania	/r/RelatedTo 	albania /r/RelatedTosoutheast Asia
columbian	/r/RelatedTo 	columbian /r/RelatedTocricket
peruvian	/r/RelatedTo 	peruvian /r/RelatedToperuvian culture
argentian	/r/RelatedTo 	argentian /r/RelatedTomilitary rank
spain	/r/RelatedTo 	spain /r/RelatedTospare part of external body organism
paraguay	/r/RelatedTo 	paraguay /r/RelatedToplunge
ethiopian	/r/RelatedTo 	ethiopian /r/RelatedTohuman population
egyptian	/r/RelatedTo 	egyptian /r/RelatedToisland
persian people	/r/RelatedTo 	persian people /r/RelatedTopersians
sweden	/r/RelatedTo 	sweden /r/RelatedToship type
crimea	/r/RelatedTo 	crimea /r/RelatedTocrime
portuguese	/r/RelatedTo 	portuguese /r/RelatedToportuguese language type
argentina	/r/RelatedTo 	argentina /r/RelatedTomarching
chile	/r/RelatedTo 	chile /r/RelatedTodessert
cape verdean	/r/RelatedTo 	cape verdean /r/RelatedTovisual novel
turkish	/r/RelatedTo 	turkish /r/RelatedTosyrup allergy
yemeni	/r/RelatedTo 	yemeni /r/RelatedTosemi-nude
taiwan	/r/RelatedTo 	taiwan /r/RelatedTochili bread
austrian	/r/RelatedTo 	austrian /r/RelatedToathletic sport
white people	/r/RelatedTo 	white people /r/RelatedTowhite people
finland	/r/RelatedTo 	finland /r/RelatedToland conservation
australia	/r/RelatedTo 	australia /r/RelatedTobicycle-sharing
south african	/r/RelatedTo 	south african /r/RelatedToblack people
eriteria	/r/RelatedTo 	eriteria /r/RelatedToemotion
egypt	/r/RelatedTo 	egypt /r/RelatedTourban legend
korean	/r/RelatedTo 	korean /r/RelatedTojapanese language
dutch people	/r/RelatedTo 	dutch people /r/RelatedTodutch
peru	/r/RelatedTo 	peru /r/RelatedToscholarly article
poland	/r/RelatedTo 	poland /r/RelatedToartistic theme
chilean	/r/RelatedTo 	chilean /r/RelatedTopara-chilean
columbia	/r/RelatedTo 	columbia /r/RelatedTocolumbia
bolivia	/r/RelatedTo 	bolivia /r/RelatedTocoastal town
laotian	/r/RelatedTo 	laotian /r/RelatedTolabor federation
lebanese	/r/RelatedTo 	lebanese /r/RelatedTocut of lamb
japan	/r/RelatedTo 	japan /r/RelatedTojapanese language
norway	/r/RelatedTo 	norway /r/RelatedTosubdivision of landscape
cape verde	/r/RelatedTo 	cape verde /r/RelatedTofaux graphics
portugal	/r/RelatedTo 	portugal /r/RelatedToconstitution
austria	/r/RelatedTo 	austria /r/RelatedTotorture poisoning
singaporean	/r/RelatedTo 	singaporean /r/RelatedTosingaporean song
netherlands	/r/RelatedTo 	netherlands /r/RelatedTonorthern hemisphere
she	/r/RelatedTo 	she /r/RelatedTocrate
he	/r/RelatedTo 	he /r/RelatedTojazz musician
hers	/r/RelatedTo 	hers /r/RelatedToarchitectural style
him	/r/RelatedTo 	him /r/RelatedTofictional creature
her	/r/RelatedTo 	her /r/RelatedToherb
herself	/r/RelatedTo 	herself /r/RelatedToheritage site
himself	/r/RelatedTo 	himself /r/RelatedTogag
his	/r/RelatedTo 	his /r/RelatedTokinship
woman	/r/RelatedTo 	woman /r/RelatedTosociologist
man	/r/RelatedTo 	man /r/RelatedTomusical direction
female	/r/RelatedTo 	female /r/RelatedTogroup
male	/r/RelatedTo 	male /r/RelatedTohumanoid
lady	/r/RelatedTo 	lady /r/RelatedTomeeting
gentleman	/r/RelatedTo 	gentleman /r/RelatedTogentleman
ladies	/r/RelatedTo 	ladies /r/RelatedToboys club
gentlemen	/r/RelatedTo 	gentlemen /r/RelatedTogentlemen
girl	/r/RelatedTo 	girl /r/RelatedTocricket star
boy	/r/RelatedTo 	boy /r/RelatedTosports terminology
sir	/r/RelatedTo 	sir /r/RelatedTowasteful taste
ma am	/r/RelatedTo 	ma am /r/RelatedTometa category of measurement
mother	/r/RelatedTo 	mother /r/RelatedTofather
father	/r/RelatedTo 	father /r/RelatedTomale human
stepmother	/r/RelatedTo 	stepmother /r/RelatedTocaternal grandmother
stepfather	/r/RelatedTo 	stepfather /r/RelatedTofamily name
daughter	/r/RelatedTo 	daughter /r/RelatedTooccupation
son	/r/RelatedTo 	son /r/RelatedToassociate
sister	/r/RelatedTo 	sister /r/RelatedTobrother
brother	/r/RelatedTo 	brother /r/RelatedTobrother
grandmother	/r/RelatedTo 	grandmother /r/RelatedTodaughter
grandfather	/r/RelatedTo 	grandfather /r/RelatedTochild
mommy	/r/RelatedTo 	mommy /r/RelatedTodude
daddy	/r/RelatedTo 	daddy /r/RelatedTopaternal son
wife	/r/RelatedTo 	wife /r/RelatedTosister
husband	/r/RelatedTo 	husband /r/RelatedTofemale human
bride	/r/RelatedTo 	bride /r/RelatedTocompassion
groom	/r/RelatedTo 	groom /r/RelatedTogroom
girlfriend	/r/RelatedTo 	girlfriend /r/RelatedTosouthern woman
boyfriend	/r/RelatedTo 	boyfriend /r/RelatedToboyfriend activity
schoolgirl	/r/RelatedTo 	schoolgirl /r/RelatedTomagazine character
schoolboy	/r/RelatedTo 	schoolboy /r/RelatedTosports video game
sharia	/r/RelatedTo 	sharia /r/RelatedToislam
jihad	/r/RelatedTo 	jihad /r/RelatedTojihadism
christian	/r/RelatedTo 	christian /r/RelatedTochristian worship
muslim	/r/RelatedTo 	muslim /r/RelatedTomusical style
islam	/r/RelatedTo 	islam /r/RelatedToyume
hindu	/r/RelatedTo 	hindu /r/RelatedTohindu
mohammed	/r/RelatedTo 	mohammed /r/RelatedTonursing
church	/r/RelatedTo 	church /r/RelatedTohistorical country
quran	/r/RelatedTo 	quran /r/RelatedToscholarly article
bible	/r/RelatedTo 	bible /r/RelatedTopropaganda
brahmin	/r/RelatedTo 	brahmin /r/RelatedToherb
holy trinity	/r/RelatedTo 	holy trinity /r/RelatedTomythical character
barber	/r/RelatedTo 	barber /r/RelatedTobarber
coach	/r/RelatedTo 	coach /r/RelatedTosports discipline
businessperson	/r/RelatedTo 	businessperson /r/RelatedTobusinessperson
football player	/r/RelatedTo 	football player /r/RelatedTofootball discipline
construction worker	/r/RelatedTo 	construction worker /r/RelatedToconsultant
manager	/r/RelatedTo 	manager /r/RelatedTopuppet
ceo	/r/RelatedTo 	ceo /r/RelatedTofictional character
accountant	/r/RelatedTo 	accountant /r/RelatedToposition
commander	/r/RelatedTo 	commander /r/RelatedTogeneral
firefighter	/r/RelatedTo 	firefighter /r/RelatedTomarine warfare
mover	/r/RelatedTo 	mover /r/RelatedTohuman body part
software developer	/r/RelatedTo 	software developer /r/RelatedTosoftware developer
guard	/r/RelatedTo 	guard /r/RelatedTohand tool
baker	/r/RelatedTo 	baker /r/RelatedTocinnamon sauce
doctor	/r/RelatedTo 	doctor /r/RelatedTomedical profession
athlete	/r/RelatedTo 	athlete /r/RelatedToathletic qualification
artist	/r/RelatedTo 	artist /r/RelatedTooccupation
dancer	/r/RelatedTo 	dancer /r/RelatedTofisher
mathematician	/r/RelatedTo 	mathematician /r/RelatedTomathematical profession
janitor	/r/RelatedTo 	janitor /r/RelatedTobadminton player
carpenter	/r/RelatedTo 	carpenter /r/RelatedTooccupation
mechanic	/r/RelatedTo 	mechanic /r/RelatedTomechanic
actor	/r/RelatedTo 	actor /r/RelatedTotheatrical character
handyman	/r/RelatedTo 	handyman /r/RelatedTogreeting
musician	/r/RelatedTo 	musician /r/RelatedTomusical profession
detective	/r/RelatedTo 	detective /r/RelatedTodetective
politician	/r/RelatedTo 	politician /r/RelatedTomusician
entrepreneur	/r/RelatedTo 	entrepreneur /r/RelatedToposition
model	/r/RelatedTo 	model /r/RelatedTomodel
opera singer	/r/RelatedTo 	opera singer /r/RelatedToparody singer
chief	/r/RelatedTo 	chief /r/RelatedTolegal term
lawyer	/r/RelatedTo 	lawyer /r/RelatedTolegal professional
farmer	/r/RelatedTo 	farmer /r/RelatedTocricket
writer	/r/RelatedTo 	writer /r/RelatedToposition
librarian	/r/RelatedTo 	librarian /r/RelatedToliterary profession
army	/r/RelatedTo 	army /r/RelatedTodefense unit
real estate developer	/r/RelatedTo 	real estate developer /r/RelatedTooccupation
broker	/r/RelatedTo 	broker /r/RelatedTobanker
scientist	/r/RelatedTo 	scientist /r/RelatedToscholar
butcher	/r/RelatedTo 	butcher /r/RelatedToartistic gymnastics training
electrician	/r/RelatedTo 	electrician /r/RelatedToelectrician
prosecutor	/r/RelatedTo 	prosecutor /r/RelatedTolegal guardian
banker	/r/RelatedTo 	banker /r/RelatedTocricket
cook	/r/RelatedTo 	cook /r/RelatedTobiblical medicine
hairdresser	/r/RelatedTo 	hairdresser /r/RelatedTohair ornament
prisoner	/r/RelatedTo 	prisoner /r/RelatedToprisoner
plumber	/r/RelatedTo 	plumber /r/RelatedToplaster
attorney	/r/RelatedTo 	attorney /r/RelatedTolegal professional
boxer	/r/RelatedTo 	boxer /r/RelatedToboxer
chess player	/r/RelatedTo 	chess player /r/RelatedToscholarly article
priest	/r/RelatedTo 	priest /r/RelatedTopriest
swimmer	/r/RelatedTo 	swimmer /r/RelatedToswimming technique
tennis player	/r/RelatedTo 	tennis player /r/RelatedTosports discipline
supervisor	/r/RelatedTo 	supervisor /r/RelatedTovisor service
attendant	/r/RelatedTo 	attendant /r/RelatedTocustodian
housekeeper	/r/RelatedTo 	housekeeper /r/RelatedTooccupation
maid	/r/RelatedTo 	maid /r/RelatedTohuman figure
producer	/r/RelatedTo 	producer /r/RelatedTofilm crew member
researcher	/r/RelatedTo 	researcher /r/RelatedTovideo game mechanic
midwife	/r/RelatedTo 	midwife /r/RelatedTomotherhood
judge	/r/RelatedTo 	judge /r/RelatedTojudge
umpire	/r/RelatedTo 	umpire /r/RelatedToposition
bartender	/r/RelatedTo 	bartender /r/RelatedTosales
economist	/r/RelatedTo 	economist /r/RelatedToeconomic writer
physicist	/r/RelatedTo 	physicist /r/RelatedTooccupation
psychologist	/r/RelatedTo 	psychologist /r/RelatedTopsychologist
theologian	/r/RelatedTo 	theologian /r/RelatedToscientific method
salesperson	/r/RelatedTo 	salesperson /r/RelatedTocensus entry
physician	/r/RelatedTo 	physician /r/RelatedTophysician
sheriff	/r/RelatedTo 	sheriff /r/RelatedToshelter
cashier	/r/RelatedTo 	cashier /r/RelatedTofinancial professional
assistant	/r/RelatedTo 	assistant /r/RelatedToassistant
receptionist	/r/RelatedTo 	receptionist /r/RelatedTojournalist
editor	/r/RelatedTo 	editor /r/RelatedToeditor
engineer	/r/RelatedTo 	engineer /r/RelatedToship type
comedian	/r/RelatedTo 	comedian /r/RelatedToprofessional
painter	/r/RelatedTo 	painter /r/RelatedTopainting process
civil servant	/r/RelatedTo 	civil servant /r/RelatedTosocial service worker
diplomat	/r/RelatedTo 	diplomat /r/RelatedToforeign policy
guitarist	/r/RelatedTo 	guitarist /r/RelatedTomusic historian
linguist	/r/RelatedTo 	linguist /r/RelatedTogeographical photographer
poet	/r/RelatedTo 	poet /r/RelatedTomusical instrument
laborer	/r/RelatedTo 	laborer /r/RelatedToworkmen group
teacher	/r/RelatedTo 	teacher /r/RelatedToschool teacher
delivery man	/r/RelatedTo 	delivery man /r/RelatedTodelivery industry
realtor	/r/RelatedTo 	realtor /r/RelatedTorescue worker
pilot	/r/RelatedTo 	pilot /r/RelatedToship type
professor	/r/RelatedTo 	professor /r/RelatedToposition
chemist	/r/RelatedTo 	chemist /r/RelatedTooccupation
historian	/r/RelatedTo 	historian /r/RelatedTohistorical material
pensioner	/r/RelatedTo 	pensioner /r/RelatedTooccupation
performing artist	/r/RelatedTo 	performing artist /r/RelatedToartistic profession
singer	/r/RelatedTo 	singer /r/RelatedTosinger
secretary	/r/RelatedTo 	secretary /r/RelatedTolegal practitioner
auditor	/r/RelatedTo 	auditor /r/RelatedToaudit
counselor	/r/RelatedTo 	counselor /r/RelatedTocounseling
designer	/r/RelatedTo 	designer /r/RelatedTodesigner position
soldier	/r/RelatedTo 	soldier /r/RelatedTomilitary rank
journalist	/r/RelatedTo 	journalist /r/RelatedTojournalist
dentist	/r/RelatedTo 	dentist /r/RelatedTomedical technician
analyst	/r/RelatedTo 	analyst /r/RelatedTooccupation
nurse	/r/RelatedTo 	nurse /r/RelatedTomaternity status
tailor	/r/RelatedTo 	tailor /r/RelatedTooccupation
waiter	/r/RelatedTo 	waiter /r/RelatedTooccupation
author	/r/RelatedTo 	author /r/RelatedTohuman lifeform
architect	/r/RelatedTo 	architect /r/RelatedToarchitectural structure
academic	/r/RelatedTo 	academic /r/RelatedToacademic
director	/r/RelatedTo 	director /r/RelatedToposition
illustrator	/r/RelatedTo 	illustrator /r/RelatedToart artist
clerk	/r/RelatedTo 	clerk /r/RelatedToclerk
policeman	/r/RelatedTo 	policeman /r/RelatedTocommandant
chef	/r/RelatedTo 	chef /r/RelatedTochef
photographer	/r/RelatedTo 	photographer /r/RelatedTophotography artist
drawer	/r/RelatedTo 	drawer /r/RelatedTohand tools
cleaner	/r/RelatedTo 	cleaner /r/RelatedTowater filter
pharmacist	/r/RelatedTo 	pharmacist /r/RelatedTopolitical activist
pianist	/r/RelatedTo 	pianist /r/RelatedTophotography supervisor
composer	/r/RelatedTo 	composer /r/RelatedTooccupation
handball player	/r/RelatedTo 	handball player /r/RelatedTohandball player
sociologist	/r/RelatedTo 	sociologist /r/RelatedTopsychologist
african american	/r/UsedFor 	african american /r/UsedForanatomy
armenian	/r/UsedFor 	armenian /r/UsedForcharm
persian	/r/UsedFor 	persian /r/UsedForpersianic
american	/r/UsedFor 	american /r/UsedForanatomical line
filipino	/r/UsedFor 	filipino /r/UsedForpistol
english	/r/UsedFor 	english /r/UsedForlanguage management
norwegian	/r/UsedFor 	norwegian /r/UsedForneo-normativity
dutch	/r/UsedFor 	dutch /r/UsedForfortification
israeli	/r/UsedFor 	israeli /r/UsedForcivil rights
nigerian	/r/UsedFor 	nigerian /r/UsedForsouthern white
ethiopia	/r/UsedFor 	ethiopia /r/UsedForfood poisoning
europe	/r/UsedFor 	europe /r/UsedForsports terminology
european	/r/UsedFor 	european /r/UsedForeuropean policy
russian	/r/UsedFor 	russian /r/UsedFornorthern hemisphere
ukraine	/r/UsedFor 	ukraine /r/UsedForrussian culture
sudan	/r/UsedFor 	sudan /r/UsedForscholarly article
afghanistan	/r/UsedFor 	afghanistan /r/UsedForsources of income
iraq	/r/UsedFor 	iraq /r/UsedFornarrative device
yemen	/r/UsedFor 	yemen /r/UsedForchinese women
ukrainian	/r/UsedFor 	ukrainian /r/UsedFortongue
russia	/r/UsedFor 	russia /r/UsedForice hockey
italy	/r/UsedFor 	italy /r/UsedForhuman-anatomical line
somali	/r/UsedFor 	somali /r/UsedForsouthern hemisphere
iran	/r/UsedFor 	iran /r/UsedForcavity of dorsal part of left external ear
afghan	/r/UsedFor 	afghan /r/UsedForethnic minority
indian	/r/UsedFor 	indian /r/UsedForindie
italian	/r/UsedFor 	italian /r/UsedForsoutheast
australian	/r/UsedFor 	australian /r/UsedForadopted child
spanish	/r/UsedFor 	spanish /r/UsedFormigrant occupation
guatemalan	/r/UsedFor 	guatemalan /r/UsedForhaunted place
hispanic	/r/UsedFor 	hispanic /r/UsedForwhite blood syndrome
venezuela	/r/UsedFor 	venezuela /r/UsedFormusic troupe
sudanese	/r/UsedFor 	sudanese /r/UsedForsmoked meat
oman	/r/UsedFor 	oman /r/UsedFormilitary rank
finnish	/r/UsedFor 	finnish /r/UsedForgeographic terminology
swedish	/r/UsedFor 	swedish /r/UsedForjazz music
venezuelan	/r/UsedFor 	venezuelan /r/UsedForeau de sac
puerto rican	/r/UsedFor 	puerto rican /r/UsedForghetto
ghanaian	/r/UsedFor 	ghanaian /r/UsedForgulfic acid
moroccan	/r/UsedFor 	moroccan /r/UsedForfictional analog of a specific kind of organism
somalia	/r/UsedFor 	somalia /r/UsedForeastern parts of the world
saudi arabian	/r/UsedFor 	saudi arabian /r/UsedForaria
syria	/r/UsedFor 	syria /r/UsedForcotton
chinese	/r/UsedFor 	chinese /r/UsedForchinese food
pakistani	/r/UsedFor 	pakistani /r/UsedForjihadist
china	/r/UsedFor 	china /r/UsedForcheese-and-potatoes fried chicken
india	/r/UsedFor 	india /r/UsedForindian food
irish	/r/UsedFor 	irish /r/UsedFormixed-race population
britain	/r/UsedFor 	britain /r/UsedForbritan
france	/r/UsedFor 	france /r/UsedForclassification in sports
greece	/r/UsedFor 	greece /r/UsedForsemi-freezing zone
scotland	/r/UsedFor 	scotland /r/UsedForshrimp dish
mexican	/r/UsedFor 	mexican /r/UsedForanatomical structure
paraguayan	/r/UsedFor 	paraguayan /r/UsedForgarden decoration
brazil	/r/UsedFor 	brazil /r/UsedForfortified region
african	/r/UsedFor 	african /r/UsedForafrican
eritrean	/r/UsedFor 	eritrean /r/UsedFornatural aging
sierra leonean	/r/UsedFor 	sierra leonean /r/UsedFornature reserve
africa	/r/UsedFor 	africa /r/UsedForfantastic
jordan	/r/UsedFor 	jordan /r/UsedForjoint
indonesia	/r/UsedFor 	indonesia /r/UsedForindonesia
vietnam	/r/UsedFor 	vietnam /r/UsedForcarnival
pakistan	/r/UsedFor 	pakistan /r/UsedForpapal organization
german	/r/UsedFor 	german /r/UsedForarchitectural structure
romania	/r/UsedFor 	romania /r/UsedForromantic comedy
brazilian	/r/UsedFor 	brazilian /r/UsedForcambodian
ecuadorian	/r/UsedFor 	ecuadorian /r/UsedForseminar
mexico	/r/UsedFor 	mexico /r/UsedFormachine-readable file format
puerto rico	/r/UsedFor 	puerto rico /r/UsedFormusical theme
kenyan	/r/UsedFor 	kenyan /r/UsedFormixture
liberian	/r/UsedFor 	liberian /r/UsedForforeigner
cameroonian	/r/UsedFor 	cameroonian /r/UsedForgliding
african americans	/r/UsedFor 	african americans /r/UsedFornigga
kenya	/r/UsedFor 	kenya /r/UsedForchewing noodles
liberia	/r/UsedFor 	liberia /r/UsedForliberated political movement
sierra leon	/r/UsedFor 	sierra leon /r/UsedForleon cluster
qatari	/r/UsedFor 	qatari /r/UsedForparsimony
syrian	/r/UsedFor 	syrian /r/UsedForsyrian culture
arab	/r/UsedFor 	arab /r/UsedForpile
saudi arabia	/r/UsedFor 	saudi arabia /r/UsedForsaudi tree
lebanon	/r/UsedFor 	lebanon /r/UsedForflax and sugar /r/flax ingredient
indonesian	/r/UsedFor 	indonesian /r/UsedForindonesian culture
french	/r/UsedFor 	french /r/UsedForclass of fictional entities
norwegian	/r/UsedFor 	norwegian /r/UsedForalpine region
south africa	/r/UsedFor 	south africa /r/UsedForsubdivision of a single island
jordanian	/r/UsedFor 	jordanian /r/UsedForjordanist
korea	/r/UsedFor 	korea /r/UsedForbouquet
singapore	/r/UsedFor 	singapore /r/UsedForsingapore architecture
romanian	/r/UsedFor 	romanian /r/UsedForanarchist
crimean	/r/UsedFor 	crimean /r/UsedForbadminton
native american	/r/UsedFor 	native american /r/UsedForethnicly-populated region
germany	/r/UsedFor 	germany /r/UsedForscholarly article
ireland	/r/UsedFor 	ireland /r/UsedForterritorial entity
ecuador	/r/UsedFor 	ecuador /r/UsedForpsychology terminology
morocco	/r/UsedFor 	morocco /r/UsedForliterary genre
omani	/r/UsedFor 	omani /r/UsedForplastic
iranian	/r/UsedFor 	iranian /r/UsedForr/DistinctFromyarn of animals
iraqi	/r/UsedFor 	iraqi /r/UsedForguitar playing card
qatar	/r/UsedFor 	qatar /r/UsedForisrae
turkey	/r/UsedFor 	turkey /r/UsedForsausage dish
vietnamese	/r/UsedFor 	vietnamese /r/UsedForvietnamese food
nepali	/r/UsedFor 	nepali /r/UsedFortheatrical genre
laos	/r/UsedFor 	laos /r/UsedFortorture
bangladesh	/r/UsedFor 	bangladesh /r/UsedForpork food
british	/r/UsedFor 	british /r/UsedForpsychology terminology
polish	/r/UsedFor 	polish /r/UsedForcolor
greek	/r/UsedFor 	greek /r/UsedForgarden vegetable
scottish	/r/UsedFor 	scottish /r/UsedForscholarly article
bolivian	/r/UsedFor 	bolivian /r/UsedForbrown
guatemala	/r/UsedFor 	guatemala /r/UsedForguatemarilla salad
ghana	/r/UsedFor 	ghana /r/UsedForjalapeno
cameroon	/r/UsedFor 	cameroon /r/UsedForchine-on dish
japanese	/r/UsedFor 	japanese /r/UsedFordisco culture
taiwanese	/r/UsedFor 	taiwanese /r/UsedFortwins
bengali	/r/UsedFor 	bengali /r/UsedForbengal
nepal	/r/UsedFor 	nepal /r/UsedFornatural food
albanian	/r/UsedFor 	albanian /r/UsedForvigilant
albania	/r/UsedFor 	albania /r/UsedForalbania
columbian	/r/UsedFor 	columbian /r/UsedForcolumbian
peruvian	/r/UsedFor 	peruvian /r/UsedForviolet
argentian	/r/UsedFor 	argentian /r/UsedForposition
spain	/r/UsedFor 	spain /r/UsedForhuman disease
paraguay	/r/UsedFor 	paraguay /r/UsedFordancing competition
ethiopian	/r/UsedFor 	ethiopian /r/UsedForfictional entity
egyptian	/r/UsedFor 	egyptian /r/UsedForbronze
persian people	/r/UsedFor 	persian people /r/UsedFormusical group
sweden	/r/UsedFor 	sweden /r/UsedForcountry of birth
crimea	/r/UsedFor 	crimea /r/UsedForindigenous community
portuguese	/r/UsedFor 	portuguese /r/UsedForportuguese
argentina	/r/UsedFor 	argentina /r/UsedForprobability and proof theory
chile	/r/UsedFor 	chile /r/UsedForsnowboarding
cape verdean	/r/UsedFor 	cape verdean /r/UsedForverdean
turkish	/r/UsedFor 	turkish /r/UsedForturkish flag
yemeni	/r/UsedFor 	yemeni /r/UsedForsoybean
taiwan	/r/UsedFor 	taiwan /r/UsedForarchaeological heritage
austrian	/r/UsedFor 	austrian /r/UsedForbeach volleyball
white people	/r/UsedFor 	white people /r/UsedForwhite people
finland	/r/UsedFor 	finland /r/UsedForwater channel
australia	/r/UsedFor 	australia /r/UsedForcitation database
south african	/r/UsedFor 	south african /r/UsedForwest african
eriteria	/r/UsedFor 	eriteria /r/UsedFornatural geographic object
egypt	/r/UsedFor 	egypt /r/UsedForanimal subspecies
korean	/r/UsedFor 	korean /r/UsedForsaddle race
dutch people	/r/UsedFor 	dutch people /r/UsedFordomestic worker
peru	/r/UsedFor 	peru /r/UsedForfictional planet
poland	/r/UsedFor 	poland /r/UsedForplatopper
chilean	/r/UsedFor 	chilean /r/UsedForcattle meat
columbia	/r/UsedFor 	columbia /r/UsedForregion
bolivia	/r/UsedFor 	bolivia /r/UsedForgravitational phenomenon
laotian	/r/UsedFor 	laotian /r/UsedForliterary genre
lebanese	/r/UsedFor 	lebanese /r/UsedForeggshellfish
japan	/r/UsedFor 	japan /r/UsedFormusic genre
norway	/r/UsedFor 	norway /r/UsedFormusic genre
cape verde	/r/UsedFor 	cape verde /r/UsedForcolor
portugal	/r/UsedFor 	portugal /r/UsedForanatomical structure
austria	/r/UsedFor 	austria /r/UsedForfood processing
singaporean	/r/UsedFor 	singaporean /r/UsedForseapore
netherlands	/r/UsedFor 	netherlands /r/UsedForforefather
she	/r/UsedFor 	she /r/UsedForshe/r/HasContextshe
he	/r/UsedFor 	he /r/UsedForheck
hers	/r/UsedFor 	hers /r/UsedForsemi-automatic pistol
him	/r/UsedFor 	him /r/UsedForman
her	/r/UsedFor 	her /r/UsedForposition
herself	/r/UsedFor 	herself /r/UsedForphilosophical concept
himself	/r/UsedFor 	himself /r/UsedForperson of interest
his	/r/UsedFor 	his /r/UsedForpsychology terminology
woman	/r/UsedFor 	woman /r/UsedForsexual orientation
man	/r/UsedFor 	man /r/UsedForsouthern hemisphere
female	/r/UsedFor 	female /r/UsedForfemale
male	/r/UsedFor 	male /r/UsedFormale gender
lady	/r/UsedFor 	lady /r/UsedForlady
gentleman	/r/UsedFor 	gentleman /r/UsedForlabor historian
ladies	/r/UsedFor 	ladies /r/UsedFormusical group
gentlemen	/r/UsedFor 	gentlemen /r/UsedForoccupation
girl	/r/UsedFor 	girl /r/UsedForfemale character
boy	/r/UsedFor 	boy /r/UsedForoccupation
sir	/r/UsedFor 	sir /r/UsedFormusic genre
ma am	/r/UsedFor 	ma am /r/UsedForoccupation
mother	/r/UsedFor 	mother /r/UsedFormale human
father	/r/UsedFor 	father /r/UsedForfather-in-law of a single parent
stepmother	/r/UsedFor 	stepmother /r/UsedForcousin
stepfather	/r/UsedFor 	stepfather /r/UsedForfather
daughter	/r/UsedFor 	daughter /r/UsedFordaughter person
son	/r/UsedFor 	son /r/UsedForassimilation
sister	/r/UsedFor 	sister /r/UsedForkinship
brother	/r/UsedFor 	brother /r/UsedFormother
grandmother	/r/UsedFor 	grandmother /r/UsedFormother-in-law
grandfather	/r/UsedFor 	grandfather /r/UsedForlegal father
mommy	/r/UsedFor 	mommy /r/UsedForanimal food
daddy	/r/UsedFor 	daddy /r/UsedFordaddy
wife	/r/UsedFor 	wife /r/UsedForpersonality type
husband	/r/UsedFor 	husband /r/UsedForfather-in-law
bride	/r/UsedFor 	bride /r/UsedForcellular response to oxygen delivery
groom	/r/UsedFor 	groom /r/UsedForgroom /r/garden furniture
girlfriend	/r/UsedFor 	girlfriend /r/UsedForgroup therapy
boyfriend	/r/UsedFor 	boyfriend /r/UsedForchess terminology
schoolgirl	/r/UsedFor 	schoolgirl /r/UsedForsociology term
schoolboy	/r/UsedFor 	schoolboy /r/UsedForcage-playing game
sharia	/r/UsedFor 	sharia /r/UsedForsalary
jihad	/r/UsedFor 	jihad /r/UsedFormusical composition
christian	/r/UsedFor 	christian /r/UsedForchristian
muslim	/r/UsedFor 	muslim /r/UsedFormuslim and health
islam	/r/UsedFor 	islam /r/UsedForbiblical literary genre
hindu	/r/UsedFor 	hindu /r/UsedForsnowboarding
mohammed	/r/UsedFor 	mohammed /r/UsedFormechanism
church	/r/UsedFor 	church /r/UsedForchurch building
quran	/r/UsedFor 	quran /r/UsedForscholarly article
bible	/r/UsedFor 	bible /r/UsedForbiblical literature
brahmin	/r/UsedFor 	brahmin /r/UsedForchipping stone
holy trinity	/r/UsedFor 	holy trinity /r/UsedForreligious symbolism
barber	/r/UsedFor 	barber /r/UsedForhouse musician
coach	/r/UsedFor 	coach /r/UsedForposition
businessperson	/r/UsedFor 	businessperson /r/UsedForpublic law
football player	/r/UsedFor 	football player /r/UsedForinternational hockey player
construction worker	/r/UsedFor 	construction worker /r/UsedForoccupation
manager	/r/UsedFor 	manager /r/UsedForaccount manager
ceo	/r/UsedFor 	ceo /r/UsedForceo
accountant	/r/UsedFor 	accountant /r/UsedForfinancial analyst
commander	/r/UsedFor 	commander /r/UsedForposition
firefighter	/r/UsedFor 	firefighter /r/UsedForaircraft component
mover	/r/UsedFor 	mover /r/UsedFormotorsport officer
software developer	/r/UsedFor 	software developer /r/UsedForsoftware developer
guard	/r/UsedFor 	guard /r/UsedForarchitectural structure
baker	/r/UsedFor 	baker /r/UsedForcooking fluid
doctor	/r/UsedFor 	doctor /r/UsedFormedical professional
athlete	/r/UsedFor 	athlete /r/UsedForsports profession
artist	/r/UsedFor 	artist /r/UsedForfictional object
dancer	/r/UsedFor 	dancer /r/UsedFornursery
mathematician	/r/UsedFor 	mathematician /r/UsedFormathematical education
janitor	/r/UsedFor 	janitor /r/UsedForcoke collector
carpenter	/r/UsedFor 	carpenter /r/UsedForcarpentry
mechanic	/r/UsedFor 	mechanic /r/UsedFormedical specialty
actor	/r/UsedFor 	actor /r/UsedFormusical group
handyman	/r/UsedFor 	handyman /r/UsedForpawn
musician	/r/UsedFor 	musician /r/UsedFormusical profession
detective	/r/UsedFor 	detective /r/UsedForcriminal
politician	/r/UsedFor 	politician /r/UsedForpartisan
entrepreneur	/r/UsedFor 	entrepreneur /r/UsedForoccupation
model	/r/UsedFor 	model /r/UsedFormachine learning
opera singer	/r/UsedFor 	opera singer /r/UsedFormusical occupation
chief	/r/UsedFor 	chief /r/UsedForaccountability researcher
lawyer	/r/UsedFor 	lawyer /r/UsedForlegal scholar
farmer	/r/UsedFor 	farmer /r/UsedForfirst cousin
writer	/r/UsedFor 	writer /r/UsedFormusic term
librarian	/r/UsedFor 	librarian /r/UsedForlibrarian
army	/r/UsedFor 	army /r/UsedForbowling
real estate developer	/r/UsedFor 	real estate developer /r/UsedForreal estate management
broker	/r/UsedFor 	broker /r/UsedForoccupation
scientist	/r/UsedFor 	scientist /r/UsedForanalyst
butcher	/r/UsedFor 	butcher /r/UsedForfurniture style
electrician	/r/UsedFor 	electrician /r/UsedForelectrical connection
prosecutor	/r/UsedFor 	prosecutor /r/UsedForprosecutor
banker	/r/UsedFor 	banker /r/UsedForcredit card
cook	/r/UsedFor 	cook /r/UsedForcooking tip
hairdresser	/r/UsedFor 	hairdresser /r/UsedForcotton
prisoner	/r/UsedFor 	prisoner /r/UsedForprisoner
plumber	/r/UsedFor 	plumber /r/UsedForoccupation
attorney	/r/UsedFor 	attorney /r/UsedForlegal specialist
boxer	/r/UsedFor 	boxer /r/UsedFormusical instrument holder
chess player	/r/UsedFor 	chess player /r/UsedForchess terminology
priest	/r/UsedFor 	priest /r/UsedForprefecture
swimmer	/r/UsedFor 	swimmer /r/UsedForswimming pool
tennis player	/r/UsedFor 	tennis player /r/UsedForoccupation
supervisor	/r/UsedFor 	supervisor /r/UsedForsupervisor
attendant	/r/UsedFor 	attendant /r/UsedForcoupling
housekeeper	/r/UsedFor 	housekeeper /r/UsedForhousekeeping
maid	/r/UsedFor 	maid /r/UsedForlunar warfare
producer	/r/UsedFor 	producer /r/UsedForfilmmaking technique
researcher	/r/UsedFor 	researcher /r/UsedForresearsal
midwife	/r/UsedFor 	midwife /r/UsedFormidwife
judge	/r/UsedFor 	judge /r/UsedForcourtship
umpire	/r/UsedFor 	umpire /r/UsedFormount-iron
bartender	/r/UsedFor 	bartender /r/UsedFormusical instrument
economist	/r/UsedFor 	economist /r/UsedForacademic
physicist	/r/UsedFor 	physicist /r/UsedForoccupation
psychologist	/r/UsedFor 	psychologist /r/UsedForpsychologist
theologian	/r/UsedFor 	theologian /r/UsedForaspect of science
salesperson	/r/UsedFor 	salesperson /r/UsedForsportsperson
physician	/r/UsedFor 	physician /r/UsedFormedical student
sheriff	/r/UsedFor 	sheriff /r/UsedForpolice officer
cashier	/r/UsedFor 	cashier /r/UsedForcomputer forensics terminology
assistant	/r/UsedFor 	assistant /r/UsedForassociate
receptionist	/r/UsedFor 	receptionist /r/UsedForreceptionist
editor	/r/UsedFor 	editor /r/UsedForphilosophy of mathematics
engineer	/r/UsedFor 	engineer /r/UsedForoccupation
comedian	/r/UsedFor 	comedian /r/UsedForcomedian
painter	/r/UsedFor 	painter /r/UsedForpainting wood
civil servant	/r/UsedFor 	civil servant /r/UsedForhuman who holds profession
diplomat	/r/UsedFor 	diplomat /r/UsedFordiplomacy
guitarist	/r/UsedFor 	guitarist /r/UsedFormusic producer
linguist	/r/UsedFor 	linguist /r/UsedForoccupation
poet	/r/UsedFor 	poet /r/UsedForcattle dog
laborer	/r/UsedFor 	laborer /r/UsedForeconomic concept
teacher	/r/UsedFor 	teacher /r/UsedForsemi-adult
delivery man	/r/UsedFor 	delivery man /r/UsedFordelivery
realtor	/r/UsedFor 	realtor /r/UsedForprofessional photography
pilot	/r/UsedFor 	pilot /r/UsedFormilitary aviation
professor	/r/UsedFor 	professor /r/UsedForprofessor
chemist	/r/UsedFor 	chemist /r/UsedForbranch of mathematics
historian	/r/UsedFor 	historian /r/UsedForhistorical literary work
pensioner	/r/UsedFor 	pensioner /r/UsedForpayment
performing artist	/r/UsedFor 	performing artist /r/UsedForprofessional artist
singer	/r/UsedFor 	singer /r/UsedForscholarly article
secretary	/r/UsedFor 	secretary /r/UsedFordeputy
auditor	/r/UsedFor 	auditor /r/UsedForspecialty
counselor	/r/UsedFor 	counselor /r/UsedForcounseling
designer	/r/UsedFor 	designer /r/UsedFordesign process
soldier	/r/UsedFor 	soldier /r/UsedFormilitary rank
journalist	/r/UsedFor 	journalist /r/UsedForjournalist
dentist	/r/UsedFor 	dentist /r/UsedForhuman organ
analyst	/r/UsedFor 	analyst /r/UsedForphilosophical theory
nurse	/r/UsedFor 	nurse /r/UsedFormedical specialty
tailor	/r/UsedFor 	tailor /r/UsedForoccupation
waiter	/r/UsedFor 	waiter /r/UsedForexercise form
author	/r/UsedFor 	author /r/UsedForauthor
architect	/r/UsedFor 	architect /r/UsedForarchitectural style
academic	/r/UsedFor 	academic /r/UsedForacademic position
director	/r/UsedFor 	director /r/UsedForeditor
illustrator	/r/UsedFor 	illustrator /r/UsedFordrawing
clerk	/r/UsedFor 	clerk /r/UsedForclerk poisoning
policeman	/r/UsedFor 	policeman /r/UsedForoccupation
chef	/r/UsedFor 	chef /r/UsedForchicken dish
photographer	/r/UsedFor 	photographer /r/UsedForphotographer
drawer	/r/UsedFor 	drawer /r/UsedFordrawing
cleaner	/r/UsedFor 	cleaner /r/UsedFordrycleaner
pharmacist	/r/UsedFor 	pharmacist /r/UsedForcrime fiction
pianist	/r/UsedFor 	pianist /r/UsedForscholarly article
composer	/r/UsedFor 	composer /r/UsedForcarpet
handball player	/r/UsedFor 	handball player /r/UsedForhandball position
sociologist	/r/UsedFor 	sociologist /r/UsedForoccupation
african american	/r/PartOf 	african american /r/PartOfasian
armenian	/r/PartOf 	armenian /r/PartOfmilitary specialty
persian	/r/PartOf 	persian /r/PartOfchord music
american	/r/PartOf 	american /r/PartOfcinematic technique
filipino	/r/PartOf 	filipino /r/PartOffilipino
english	/r/PartOf 	english /r/PartOfformula
norwegian	/r/PartOf 	norwegian /r/PartOfpale
dutch	/r/PartOf 	dutch /r/PartOfelectrical cord
israeli	/r/PartOf 	israeli /r/PartOfoccupation
nigerian	/r/PartOf 	nigerian /r/PartOfnorthern hemisphere
ethiopia	/r/PartOf 	ethiopia /r/PartOfpig festival
europe	/r/PartOf 	europe /r/PartOfeurope /r/symbol
european	/r/PartOf 	european /r/PartOfgeographic border system
russian	/r/PartOf 	russian /r/PartOfstate
ukraine	/r/PartOf 	ukraine /r/PartOfmilitary operation
sudan	/r/PartOf 	sudan /r/PartOftribal government
afghanistan	/r/PartOf 	afghanistan /r/PartOfpossible nuclear weapons state
iraq	/r/PartOf 	iraq /r/PartOfhiking jacket
yemen	/r/PartOf 	yemen /r/PartOffemale human
ukrainian	/r/PartOf 	ukrainian /r/PartOfsouthern mountain
russia	/r/PartOf 	russia /r/PartOfwarship
italy	/r/PartOf 	italy /r/PartOfsocial problem
somali	/r/PartOf 	somali /r/PartOfsomales
iran	/r/PartOf 	iran /r/PartOfship type
afghan	/r/PartOf 	afghan /r/PartOfswimming pool
indian	/r/PartOf 	indian /r/PartOfindian cheese
italian	/r/PartOf 	italian /r/PartOfsoutheast
australian	/r/PartOf 	australian /r/PartOfalpine
spanish	/r/PartOf 	spanish /r/PartOfspatial location
guatemalan	/r/PartOf 	guatemalan /r/PartOfguatemarang
hispanic	/r/PartOf 	hispanic /r/PartOfpop culture
venezuela	/r/PartOf 	venezuela /r/PartOfventeer
sudanese	/r/PartOf 	sudanese /r/PartOfsalva
oman	/r/PartOf 	oman /r/PartOfcrown
finnish	/r/PartOf 	finnish /r/PartOfliterary genre
swedish	/r/PartOf 	swedish /r/PartOfswinging
venezuelan	/r/PartOf 	venezuelan /r/PartOfnorthern hemisphere
puerto rican	/r/PartOf 	puerto rican /r/PartOfpalate
ghanaian	/r/PartOf 	ghanaian /r/PartOfyouth group
moroccan	/r/PartOf 	moroccan /r/PartOfmorotic
somalia	/r/PartOf 	somalia /r/PartOfsomoria type
saudi arabian	/r/PartOf 	saudi arabian /r/PartOfmusic genre
syria	/r/PartOf 	syria /r/PartOfmusic genre
chinese	/r/PartOf 	chinese /r/PartOfartificial emotion emotion
pakistani	/r/PartOf 	pakistani /r/PartOfmilitary rank
china	/r/PartOf 	china /r/PartOfcheese sauce
india	/r/PartOf 	india /r/PartOfhindie
irish	/r/PartOf 	irish /r/PartOfoccupation
britain	/r/PartOf 	britain /r/PartOfsailing
france	/r/PartOf 	france /r/PartOfsport facility
greece	/r/PartOf 	greece /r/PartOfcalendar date
scotland	/r/PartOf 	scotland /r/PartOfship type
mexican	/r/PartOf 	mexican /r/PartOfmixed martial arts character
paraguayan	/r/PartOf 	paraguayan /r/PartOfmuseum work
brazil	/r/PartOf 	brazil /r/PartOfceremonious life.
african	/r/PartOf 	african /r/PartOfafrican language part
eritrean	/r/PartOf 	eritrean /r/PartOfcotton
sierra leonean	/r/PartOf 	sierra leonean /r/PartOfyoga
africa	/r/PartOf 	africa /r/PartOfbeige breeding
jordan	/r/PartOf 	jordan /r/PartOfbibliography
indonesia	/r/PartOf 	indonesia /r/PartOfindigenous languages
vietnam	/r/PartOf 	vietnam /r/PartOfterritorial entity
pakistan	/r/PartOf 	pakistan /r/PartOfterrorism in their own country
german	/r/PartOf 	german /r/PartOfoccupation
romania	/r/PartOf 	romania /r/PartOfnarrative technique
brazilian	/r/PartOf 	brazilian /r/PartOfbrazilian literature
ecuadorian	/r/PartOf 	ecuadorian /r/PartOfcricket
mexico	/r/PartOf 	mexico /r/PartOfmusic genres
puerto rico	/r/PartOf 	puerto rico /r/PartOffortified terrace
kenyan	/r/PartOf 	kenyan /r/PartOfsugar-sweetened wine
liberian	/r/PartOf 	liberian /r/PartOffictional country of the state
cameroonian	/r/PartOf 	cameroonian /r/PartOfsouthern hemisphere
african americans	/r/PartOf 	african americans /r/PartOfafrican-american
kenya	/r/PartOf 	kenya /r/PartOfbrown
liberia	/r/PartOf 	liberia /r/PartOfform of government
sierra leon	/r/PartOf 	sierra leon /r/PartOfviolet
qatari	/r/PartOf 	qatari /r/PartOfsport for tennis
syrian	/r/PartOf 	syrian /r/PartOfsyrian
arab	/r/PartOf 	arab /r/PartOfmusic genre
saudi arabia	/r/PartOf 	saudi arabia /r/PartOfsaudi
lebanon	/r/PartOf 	lebanon /r/PartOforange juice
indonesian	/r/PartOf 	indonesian /r/PartOfindonesianic
french	/r/PartOf 	french /r/PartOffrench bread
norwegian	/r/PartOf 	norwegian /r/PartOfjungle
south africa	/r/PartOf 	south africa /r/PartOfnorthwest
jordanian	/r/PartOf 	jordanian /r/PartOfjordanian
korea	/r/PartOf 	korea /r/PartOfkorea
singapore	/r/PartOf 	singapore /r/PartOfseafood salad
romanian	/r/PartOf 	romanian /r/PartOfdrama
crimean	/r/PartOf 	crimean /r/PartOfoccupation
native american	/r/PartOf 	native american /r/PartOfnative person
germany	/r/PartOf 	germany /r/PartOffood ingredient
ireland	/r/PartOf 	ireland /r/PartOfterritorial entity
ecuador	/r/PartOf 	ecuador /r/PartOfcountry of origin
morocco	/r/PartOf 	morocco /r/PartOffish food
omani	/r/PartOf 	omani /r/PartOfemotion
iranian	/r/PartOf 	iranian /r/PartOfaspect of the artist
iraqi	/r/PartOf 	iraqi /r/PartOfjazz guitar
qatar	/r/PartOf 	qatar /r/PartOfsnowfall
turkey	/r/PartOf 	turkey /r/PartOfpiano complex
vietnamese	/r/PartOf 	vietnamese /r/PartOfvietnamese food
nepali	/r/PartOf 	nepali /r/PartOfnepal poisoning
laos	/r/PartOf 	laos /r/PartOfgeographic entity
bangladesh	/r/PartOf 	bangladesh /r/PartOfdong
british	/r/PartOf 	british /r/PartOfcooking area
polish	/r/PartOf 	polish /r/PartOfdecayage
greek	/r/PartOf 	greek /r/PartOfhiking barge
scottish	/r/PartOf 	scottish /r/PartOfchocolate sauce
bolivian	/r/PartOf 	bolivian /r/PartOfmononym
guatemala	/r/PartOf 	guatemala /r/PartOfvacation
ghana	/r/PartOf 	ghana /r/PartOfcannibalism
cameroon	/r/PartOf 	cameroon /r/PartOfcompetition class
japanese	/r/PartOf 	japanese /r/PartOfjapanese culture
taiwanese	/r/PartOf 	taiwanese /r/PartOfshrimp meat
bengali	/r/PartOf 	bengali /r/PartOfclimbing
nepal	/r/PartOf 	nepal /r/PartOfepal
albanian	/r/PartOf 	albanian /r/PartOfdescent
albania	/r/PartOf 	albania /r/PartOfcoconut bread
columbian	/r/PartOf 	columbian /r/PartOfcolor blindness
peruvian	/r/PartOf 	peruvian /r/PartOfchess term
argentian	/r/PartOf 	argentian /r/PartOfmilitary rank
spain	/r/PartOf 	spain /r/PartOfpsychology terminology
paraguay	/r/PartOf 	paraguay /r/PartOfdiver
ethiopian	/r/PartOf 	ethiopian /r/PartOfoccupation
egyptian	/r/PartOf 	egyptian /r/PartOfegyptian culture
persian people	/r/PartOf 	persian people /r/PartOfsales
sweden	/r/PartOf 	sweden /r/PartOfhuman population
crimea	/r/PartOf 	crimea /r/PartOfbadminton competition
portuguese	/r/PartOf 	portuguese /r/PartOfcricket
argentina	/r/PartOf 	argentina /r/PartOfaccident
chile	/r/PartOf 	chile /r/PartOftort
cape verdean	/r/PartOf 	cape verdean /r/PartOfvocal composition
turkish	/r/PartOf 	turkish /r/PartOfturkish country
yemeni	/r/PartOf 	yemeni /r/PartOfsailor
taiwan	/r/PartOf 	taiwan /r/PartOfdeterminate
austrian	/r/PartOf 	austrian /r/PartOfmedical professional
white people	/r/PartOf 	white people /r/PartOfwhite people
finland	/r/PartOf 	finland /r/PartOfship building
australia	/r/PartOf 	australia /r/PartOfadministrative territorial entity
south african	/r/PartOf 	south african /r/PartOfseafood fish
eriteria	/r/PartOf 	eriteria /r/PartOfphenomenon
egypt	/r/PartOf 	egypt /r/PartOfegyptial geography
korean	/r/PartOf 	korean /r/PartOfgreeting
dutch people	/r/PartOf 	dutch people /r/PartOfdutch
peru	/r/PartOf 	peru /r/PartOfnatural history
poland	/r/PartOf 	poland /r/PartOfoil painting
chilean	/r/PartOf 	chilean /r/PartOfcoral arch
columbia	/r/PartOf 	columbia /r/PartOfcinnamon
bolivia	/r/PartOf 	bolivia /r/PartOfbranch of business management
laotian	/r/PartOf 	laotian /r/PartOflaboratory
lebanese	/r/PartOf 	lebanese /r/PartOfcraise
japan	/r/PartOf 	japan /r/PartOfartificial figure
norway	/r/PartOf 	norway /r/PartOfriver
cape verde	/r/PartOf 	cape verde /r/PartOfvertical line
portugal	/r/PartOf 	portugal /r/PartOfnational number
austria	/r/PartOf 	austria /r/PartOfindoor tennis court
singaporean	/r/PartOf 	singaporean /r/PartOfsummer
netherlands	/r/PartOf 	netherlands /r/PartOfterritorial entity
she	/r/PartOf 	she /r/PartOfshe of hearts
he	/r/PartOf 	he /r/PartOfsurgical operation
hers	/r/PartOf 	hers /r/PartOfseafood salad
him	/r/PartOf 	him /r/PartOfsources of information
her	/r/PartOf 	her /r/PartOfherbal medicine
herself	/r/PartOf 	herself /r/PartOfpsychologist
himself	/r/PartOf 	himself /r/PartOfidentity class
his	/r/PartOf 	his /r/PartOfassociation football team
woman	/r/PartOf 	woman /r/PartOfwomen\'s sports
man	/r/PartOf 	man /r/PartOflaborious works
female	/r/PartOf 	female /r/PartOfmale male
male	/r/PartOf 	male /r/PartOffemale activist
lady	/r/PartOf 	lady /r/PartOffolk music
gentleman	/r/PartOf 	gentleman /r/PartOfcognitive scientist
ladies	/r/PartOf 	ladies /r/PartOfassociation football team
gentlemen	/r/PartOf 	gentlemen /r/PartOfhouse
girl	/r/PartOf 	girl /r/PartOffictional human
boy	/r/PartOf 	boy /r/PartOffilm crew member
sir	/r/PartOf 	sir /r/PartOfscholarly article
ma am	/r/PartOf 	ma am /r/PartOfnurse
mother	/r/PartOf 	mother /r/PartOffather or mother by birth
father	/r/PartOf 	father /r/PartOfnoble title
stepmother	/r/PartOf 	stepmother /r/PartOffather
stepfather	/r/PartOf 	stepfather /r/PartOfcousin
daughter	/r/PartOf 	daughter /r/PartOfnervous system disease
son	/r/PartOf 	son /r/PartOfskinship
sister	/r/PartOf 	sister /r/PartOfdietary commitment
brother	/r/PartOf 	brother /r/PartOfsibling
grandmother	/r/PartOf 	grandmother /r/PartOfgrandmother
grandfather	/r/PartOf 	grandfather /r/PartOfgranddaughter
mommy	/r/PartOf 	mommy /r/PartOfsibling
daddy	/r/PartOf 	daddy /r/PartOfrole-playing game
wife	/r/PartOf 	wife /r/PartOfwife
husband	/r/PartOf 	husband /r/PartOfkinship
bride	/r/PartOf 	bride /r/PartOffountain of sand
groom	/r/PartOf 	groom /r/PartOfgarden /r/garden
girlfriend	/r/PartOf 	girlfriend /r/PartOfpregnancy
boyfriend	/r/PartOf 	boyfriend /r/PartOfboyfriend
schoolgirl	/r/PartOf 	schoolgirl /r/PartOfnarrative art
schoolboy	/r/PartOf 	schoolboy /r/PartOfschoolgirl
sharia	/r/PartOf 	sharia /r/PartOfsharia
jihad	/r/PartOf 	jihad /r/PartOfjihadist
christian	/r/PartOf 	christian /r/PartOfreligious icon
muslim	/r/PartOf 	muslim /r/PartOfmuslim musician
islam	/r/PartOf 	islam /r/PartOfterrorism
hindu	/r/PartOf 	hindu /r/PartOfhindu
mohammed	/r/PartOf 	mohammed /r/PartOffictional human
church	/r/PartOf 	church /r/PartOfchurch building
quran	/r/PartOf 	quran /r/PartOfsalma
bible	/r/PartOf 	bible /r/PartOfbiblical archaeology
brahmin	/r/PartOf 	brahmin /r/PartOfbrahm tree
holy trinity	/r/PartOf 	holy trinity /r/PartOfprinciple of law
barber	/r/PartOf 	barber /r/PartOfcarber
coach	/r/PartOf 	coach /r/PartOfgroup of organisms known by one particular common name
businessperson	/r/PartOf 	businessperson /r/PartOfperson
football player	/r/PartOf 	football player /r/PartOffootball player
construction worker	/r/PartOf 	construction worker /r/PartOfoccupation
manager	/r/PartOf 	manager /r/PartOfformer employee
ceo	/r/PartOf 	ceo /r/PartOfscent
accountant	/r/PartOf 	accountant /r/PartOfaccountant
commander	/r/PartOf 	commander /r/PartOfcommander
firefighter	/r/PartOf 	firefighter /r/PartOffirearm crew
mover	/r/PartOf 	mover /r/PartOfposition
software developer	/r/PartOf 	software developer /r/PartOfsoftware engineer
guard	/r/PartOf 	guard /r/PartOfstaff
baker	/r/PartOf 	baker /r/PartOftaste
doctor	/r/PartOf 	doctor /r/PartOfdazzle
athlete	/r/PartOf 	athlete /r/PartOfathlete
artist	/r/PartOf 	artist /r/PartOffilm crew member
dancer	/r/PartOf 	dancer /r/PartOfdrinking game
mathematician	/r/PartOf 	mathematician /r/PartOfmathematical science
janitor	/r/PartOf 	janitor /r/PartOfarchitectural element
carpenter	/r/PartOf 	carpenter /r/PartOfsports commissioner
mechanic	/r/PartOf 	mechanic /r/PartOfoccupation
actor	/r/PartOf 	actor /r/PartOfsheltered building
handyman	/r/PartOf 	handyman /r/PartOfdressed-up artist
musician	/r/PartOf 	musician /r/PartOfmusical artist
detective	/r/PartOf 	detective /r/PartOfdetective
politician	/r/PartOf 	politician /r/PartOfpolitical activist
entrepreneur	/r/PartOf 	entrepreneur /r/PartOfemployee
model	/r/PartOf 	model /r/PartOfeconomic concept
opera singer	/r/PartOf 	opera singer /r/PartOfopera producer
chief	/r/PartOf 	chief /r/PartOfchief
lawyer	/r/PartOf 	lawyer /r/PartOflawyer
farmer	/r/PartOf 	farmer /r/PartOfcivil engineer
writer	/r/PartOf 	writer /r/PartOfposition
librarian	/r/PartOf 	librarian /r/PartOflibrary technician
army	/r/PartOf 	army /r/PartOfarmy
real estate developer	/r/PartOf 	real estate developer /r/PartOfapplied science
broker	/r/PartOf 	broker /r/PartOfbroker
scientist	/r/PartOf 	scientist /r/PartOfscientific researcher
butcher	/r/PartOf 	butcher /r/PartOftortured animals
electrician	/r/PartOf 	electrician /r/PartOfaircraft component
prosecutor	/r/PartOf 	prosecutor /r/PartOfpunishment
banker	/r/PartOf 	banker /r/PartOffictional bank
cook	/r/PartOf 	cook /r/PartOfcooking equipment
hairdresser	/r/PartOf 	hairdresser /r/PartOfhometown
prisoner	/r/PartOf 	prisoner /r/PartOfprisoner
plumber	/r/PartOf 	plumber /r/PartOfdevice
attorney	/r/PartOf 	attorney /r/PartOflegal profession
boxer	/r/PartOf 	boxer /r/PartOfdesigner
chess player	/r/PartOf 	chess player /r/PartOfchess trainer
priest	/r/PartOf 	priest /r/PartOfposition
swimmer	/r/PartOf 	swimmer /r/PartOfsports discipline
tennis player	/r/PartOf 	tennis player /r/PartOftennis tour
supervisor	/r/PartOf 	supervisor /r/PartOfsuperior officer
attendant	/r/PartOf 	attendant /r/PartOfkinship
housekeeper	/r/PartOf 	housekeeper /r/PartOffarm worker
maid	/r/PartOf 	maid /r/PartOfmaiden
producer	/r/PartOf 	producer /r/PartOffilm crew member
researcher	/r/PartOf 	researcher /r/PartOfsports medicine
midwife	/r/PartOf 	midwife /r/PartOffemale human
judge	/r/PartOf 	judge /r/PartOfjudge
umpire	/r/PartOf 	umpire /r/PartOfwheeling
bartender	/r/PartOf 	bartender /r/PartOfcarpet dress
economist	/r/PartOf 	economist /r/PartOfeconomic branch
physicist	/r/PartOf 	physicist /r/PartOfscience fiction character
psychologist	/r/PartOf 	psychologist /r/PartOfpsychologist
theologian	/r/PartOf 	theologian /r/PartOfoccupation
salesperson	/r/PartOf 	salesperson /r/PartOfperson
physician	/r/PartOf 	physician /r/PartOfprofessional
sheriff	/r/PartOf 	sheriff /r/PartOfpublic function
cashier	/r/PartOf 	cashier /r/PartOfspecialty
assistant	/r/PartOf 	assistant /r/PartOfassistant
receptionist	/r/PartOf 	receptionist /r/PartOfreceptionist
editor	/r/PartOf 	editor /r/PartOfposition
engineer	/r/PartOf 	engineer /r/PartOfengineering process
comedian	/r/PartOf 	comedian /r/PartOfcomedian and
painter	/r/PartOf 	painter /r/PartOfpainting tool
civil servant	/r/PartOf 	civil servant /r/PartOfservant
diplomat	/r/PartOf 	diplomat /r/PartOfgovernment office
guitarist	/r/PartOf 	guitarist /r/PartOfhouse band
linguist	/r/PartOf 	linguist /r/PartOfoccupation
poet	/r/PartOf 	poet /r/PartOftennis terminology
laborer	/r/PartOf 	laborer /r/PartOffarm worker
teacher	/r/PartOf 	teacher /r/PartOfscholar
delivery man	/r/PartOf 	delivery man /r/PartOfconverter
realtor	/r/PartOf 	realtor /r/PartOfcoach
pilot	/r/PartOf 	pilot /r/PartOfcockpit
professor	/r/PartOf 	professor /r/PartOfoccupation
chemist	/r/PartOf 	chemist /r/PartOfnoble title
historian	/r/PartOf 	historian /r/PartOfhistorical profession
pensioner	/r/PartOf 	pensioner /r/PartOflegal case
performing artist	/r/PartOf 	performing artist /r/PartOfartist type
singer	/r/PartOf 	singer /r/PartOfsports discipline
secretary	/r/PartOf 	secretary /r/PartOfofficial
auditor	/r/PartOf 	auditor /r/PartOfadministrator
counselor	/r/PartOf 	counselor /r/PartOfbribery
designer	/r/PartOf 	designer /r/PartOfdesigner
soldier	/r/PartOf 	soldier /r/PartOfmilitary rank
journalist	/r/PartOf 	journalist /r/PartOfjournalist
dentist	/r/PartOf 	dentist /r/PartOfdental surgeon
analyst	/r/PartOf 	analyst /r/PartOfacademic major
nurse	/r/PartOf 	nurse /r/PartOfneurology
tailor	/r/PartOf 	tailor /r/PartOffilm crew person
waiter	/r/PartOf 	waiter /r/PartOfoccupation
author	/r/PartOf 	author /r/PartOfuser information
architect	/r/PartOf 	architect /r/PartOfarchitectural style
academic	/r/PartOf 	academic /r/PartOfcompetent of course
director	/r/PartOf 	director /r/PartOfpolitical party
illustrator	/r/PartOf 	illustrator /r/PartOfeditor
clerk	/r/PartOf 	clerk /r/PartOfcluster
policeman	/r/PartOf 	policeman /r/PartOfoccupation
chef	/r/PartOf 	chef /r/PartOfchef
photographer	/r/PartOf 	photographer /r/PartOfphotographer
drawer	/r/PartOf 	drawer /r/PartOfoccupation
cleaner	/r/PartOf 	cleaner /r/PartOfwater supply
pharmacist	/r/PartOf 	pharmacist /r/PartOfphilosophical activity
pianist	/r/PartOf 	pianist /r/PartOfmusic director
composer	/r/PartOf 	composer /r/PartOfcompetition
handball player	/r/PartOf 	handball player /r/PartOfoccupation
sociologist	/r/PartOf 	sociologist /r/PartOfscholar
african american	/r/MadeOf 	african american /r/MadeOfbeaver
armenian	/r/MadeOf 	armenian /r/MadeOfartificial figure
persian	/r/MadeOf 	persian /r/MadeOfpersian
american	/r/MadeOf 	american /r/MadeOfoccupation
filipino	/r/MadeOf 	filipino /r/MadeOfanimal fat
english	/r/MadeOf 	english /r/MadeOfsports terminology
norwegian	/r/MadeOf 	norwegian /r/MadeOfnocturnal person
dutch	/r/MadeOf 	dutch /r/MadeOfbanking system
israeli	/r/MadeOf 	israeli /r/MadeOfoccupation
nigerian	/r/MadeOf 	nigerian /r/MadeOfnigga
ethiopia	/r/MadeOf 	ethiopia /r/MadeOfcabinet
europe	/r/MadeOf 	europe /r/MadeOfisland zone
european	/r/MadeOf 	european /r/MadeOfeuropean union
russian	/r/MadeOf 	russian /r/MadeOfmilitary authority
ukraine	/r/MadeOf 	ukraine /r/MadeOfhusseshoe
sudan	/r/MadeOf 	sudan /r/MadeOfsudan and its chemical compound
afghanistan	/r/MadeOf 	afghanistan /r/MadeOfinfluence
iraq	/r/MadeOf 	iraq /r/MadeOftorture
yemen	/r/MadeOf 	yemen /r/MadeOfmaternal aunt
ukrainian	/r/MadeOf 	ukrainian /r/MadeOfasians
russia	/r/MadeOf 	russia /r/MadeOfscholarly article
italy	/r/MadeOf 	italy /r/MadeOfmusical profession
somali	/r/MadeOf 	somali /r/MadeOfsomalian religion
iran	/r/MadeOf 	iran /r/MadeOfreligious organisation
afghan	/r/MadeOf 	afghan /r/MadeOfnarrowly defined region
indian	/r/MadeOf 	indian /r/MadeOflanguage variety
italian	/r/MadeOf 	italian /r/MadeOfexterior
australian	/r/MadeOf 	australian /r/MadeOfsouthern hemisphere
spanish	/r/MadeOf 	spanish /r/MadeOfsynthetic resin
guatemalan	/r/MadeOf 	guatemalan /r/MadeOfguanamanese
hispanic	/r/MadeOf 	hispanic /r/MadeOfdomestic dog
venezuela	/r/MadeOf 	venezuela /r/MadeOfliquor
sudanese	/r/MadeOf 	sudanese /r/MadeOfcricket
oman	/r/MadeOf 	oman /r/MadeOfliterary genre
finnish	/r/MadeOf 	finnish /r/MadeOffolk culture
swedish	/r/MadeOf 	swedish /r/MadeOfbitch
venezuelan	/r/MadeOf 	venezuelan /r/MadeOfmusic genre
puerto rican	/r/MadeOf 	puerto rican /r/MadeOfpregnant woman
ghanaian	/r/MadeOf 	ghanaian /r/MadeOfnorthern region
moroccan	/r/MadeOf 	moroccan /r/MadeOffictional character
somalia	/r/MadeOf 	somalia /r/MadeOffishing industry
saudi arabian	/r/MadeOf 	saudi arabian /r/MadeOfscholarly article
syria	/r/MadeOf 	syria /r/MadeOfpsychology terminology
chinese	/r/MadeOf 	chinese /r/MadeOfchess terminology
pakistani	/r/MadeOf 	pakistani /r/MadeOfwisdom
china	/r/MadeOf 	china /r/MadeOfchinese food dish
india	/r/MadeOf 	india /r/MadeOfindian state
irish	/r/MadeOf 	irish /r/MadeOfscholarly article
britain	/r/MadeOf 	britain /r/MadeOfbritain culture
france	/r/MadeOf 	france /r/MadeOffortification
greece	/r/MadeOf 	greece /r/MadeOfgeographic object
scotland	/r/MadeOf 	scotland /r/MadeOfship of worship
mexican	/r/MadeOf 	mexican /r/MadeOfliterary genre
paraguayan	/r/MadeOf 	paraguayan /r/MadeOfparag
brazil	/r/MadeOf 	brazil /r/MadeOflabor place
african	/r/MadeOf 	african /r/MadeOfartistic structure
eritrean	/r/MadeOf 	eritrean /r/MadeOfnude
sierra leonean	/r/MadeOf 	sierra leonean /r/MadeOffishing vessel
africa	/r/MadeOf 	africa /r/MadeOfagricultural area
jordan	/r/MadeOf 	jordan /r/MadeOfmilitary rank
indonesia	/r/MadeOf 	indonesia /r/MadeOfindoor sports
vietnam	/r/MadeOf 	vietnam /r/MadeOftension island
pakistan	/r/MadeOf 	pakistan /r/MadeOfgeographical area
german	/r/MadeOf 	german /r/MadeOfbronze
romania	/r/MadeOf 	romania /r/MadeOfmanga
brazilian	/r/MadeOf 	brazilian /r/MadeOfcricket player
ecuadorian	/r/MadeOf 	ecuadorian /r/MadeOfsoutheast
mexico	/r/MadeOf 	mexico /r/MadeOfhuman figure
puerto rico	/r/MadeOf 	puerto rico /r/MadeOfcoffee drinking
kenyan	/r/MadeOf 	kenyan /r/MadeOfcolor
liberian	/r/MadeOf 	liberian /r/MadeOfindigenous
cameroonian	/r/MadeOf 	cameroonian /r/MadeOfmeteorological information source
african americans	/r/MadeOf 	african americans /r/MadeOfcricket
kenya	/r/MadeOf 	kenya /r/MadeOffruit vegetable
liberia	/r/MadeOf 	liberia /r/MadeOflibertarian political group
sierra leon	/r/MadeOf 	sierra leon /r/MadeOfsnowboarding
qatari	/r/MadeOf 	qatari /r/MadeOfyar
syrian	/r/MadeOf 	syrian /r/MadeOfsyrian food and drink
arab	/r/MadeOf 	arab /r/MadeOfnarrative format
saudi arabia	/r/MadeOf 	saudi arabia /r/MadeOfarsenic
lebanon	/r/MadeOf 	lebanon /r/MadeOffleece
indonesian	/r/MadeOf 	indonesian /r/MadeOfindonesian state
french	/r/MadeOf 	french /r/MadeOfbarmy
norwegian	/r/MadeOf 	norwegian /r/MadeOfmusic terminology
south africa	/r/MadeOf 	south africa /r/MadeOfindocean
jordanian	/r/MadeOf 	jordanian /r/MadeOfjaxer
korea	/r/MadeOf 	korea /r/MadeOfcultural heritage area
singapore	/r/MadeOf 	singapore /r/MadeOflandscape landscape
romanian	/r/MadeOf 	romanian /r/MadeOfreligious culture
crimean	/r/MadeOf 	crimean /r/MadeOfcrime victim
native american	/r/MadeOf 	native american /r/MadeOfartistic technique
germany	/r/MadeOf 	germany /r/MadeOffarm income
ireland	/r/MadeOf 	ireland /r/MadeOfgeographic region
ecuador	/r/MadeOf 	ecuador /r/MadeOffictional location
morocco	/r/MadeOf 	morocco /r/MadeOffishing vessel
omani	/r/MadeOf 	omani /r/MadeOfmetroelectric power station
iranian	/r/MadeOf 	iranian /r/MadeOfdwarf
iraqi	/r/MadeOf 	iraqi /r/MadeOfreligious scholar
qatar	/r/MadeOf 	qatar /r/MadeOfship type
turkey	/r/MadeOf 	turkey /r/MadeOffood ingredient
vietnamese	/r/MadeOf 	vietnamese /r/MadeOfvietnamese people
nepali	/r/MadeOf 	nepali /r/MadeOfhistorical fiction
laos	/r/MadeOf 	laos /r/MadeOfshade of yellow
bangladesh	/r/MadeOf 	bangladesh /r/MadeOfbicycle seat
british	/r/MadeOf 	british /r/MadeOfchess terminology
polish	/r/MadeOf 	polish /r/MadeOfpainting technique
greek	/r/MadeOf 	greek /r/MadeOfgeographical region
scottish	/r/MadeOf 	scottish /r/MadeOfhuman action
bolivian	/r/MadeOf 	bolivian /r/MadeOfindigenous
guatemala	/r/MadeOf 	guatemala /r/MadeOfamusement park
ghana	/r/MadeOf 	ghana /r/MadeOfglossary of terms
cameroon	/r/MadeOf 	cameroon /r/MadeOfgeographic system
japanese	/r/MadeOf 	japanese /r/MadeOfjapanese music genre
taiwanese	/r/MadeOf 	taiwanese /r/MadeOfsemi-dowdowd, semi-literary state
bengali	/r/MadeOf 	bengali /r/MadeOfbengali
nepal	/r/MadeOf 	nepal /r/MadeOfdiplomatic channel
albanian	/r/MadeOf 	albanian /r/MadeOfcoral
albania	/r/MadeOf 	albania /r/MadeOfclement island
columbian	/r/MadeOf 	columbian /r/MadeOfcultural figure
peruvian	/r/MadeOf 	peruvian /r/MadeOfcultural landscape or structure
argentian	/r/MadeOf 	argentian /r/MadeOfoccupation
spain	/r/MadeOf 	spain /r/MadeOfdisease
paraguay	/r/MadeOf 	paraguay /r/MadeOfparaguagoul
ethiopian	/r/MadeOf 	ethiopian /r/MadeOfphilosophical concept
egyptian	/r/MadeOf 	egyptian /r/MadeOffugitive
persian people	/r/MadeOf 	persian people /r/MadeOffictional human
sweden	/r/MadeOf 	sweden /r/MadeOfswedish
crimea	/r/MadeOf 	crimea /r/MadeOflegal profession
portuguese	/r/MadeOf 	portuguese /r/MadeOfportuguese cuisine
argentina	/r/MadeOf 	argentina /r/MadeOfcontraception
chile	/r/MadeOf 	chile /r/MadeOfpapal dish
cape verdean	/r/MadeOf 	cape verdean /r/MadeOfvocal technique
turkish	/r/MadeOf 	turkish /r/MadeOfprovisional policy
yemeni	/r/MadeOf 	yemeni /r/MadeOfwomen in combat
taiwan	/r/MadeOf 	taiwan /r/MadeOfbamboo
austrian	/r/MadeOf 	austrian /r/MadeOfartistic theme
white people	/r/MadeOf 	white people /r/MadeOfwhite people
finland	/r/MadeOf 	finland /r/MadeOfsources of food and medicine (d)
australia	/r/MadeOf 	australia /r/MadeOfdistinctive region of the world
south african	/r/MadeOf 	south african /r/MadeOfsouth african
eriteria	/r/MadeOf 	eriteria /r/MadeOfpsychology terminology
egypt	/r/MadeOf 	egypt /r/MadeOfcultural heritage location
korean	/r/MadeOf 	korean /r/MadeOfkeen
dutch people	/r/MadeOf 	dutch people /r/MadeOfdomestic worker
peru	/r/MadeOf 	peru /r/MadeOfliterary genre
poland	/r/MadeOf 	poland /r/MadeOfpsychology terminology
chilean	/r/MadeOf 	chilean /r/MadeOfhistorical geographic position
columbia	/r/MadeOf 	columbia /r/MadeOfcolor
bolivia	/r/MadeOf 	bolivia /r/MadeOfpueblo
laotian	/r/MadeOf 	laotian /r/MadeOfcricket
lebanese	/r/MadeOf 	lebanese /r/MadeOflebanese salad
japan	/r/MadeOf 	japan /r/MadeOflithium deficiency
norway	/r/MadeOf 	norway /r/MadeOfurbanization
cape verde	/r/MadeOf 	cape verde /r/MadeOfvision
portugal	/r/MadeOf 	portugal /r/MadeOfsocial inequality
austria	/r/MadeOf 	austria /r/MadeOfbritish
singaporean	/r/MadeOf 	singaporean /r/MadeOfsingaporean
netherlands	/r/MadeOf 	netherlands /r/MadeOfterrain
she	/r/MadeOf 	she /r/MadeOfmeander
he	/r/MadeOf 	he /r/MadeOfbody part
hers	/r/MadeOf 	hers /r/MadeOfmusical group
him	/r/MadeOf 	him /r/MadeOfmale human
her	/r/MadeOf 	her /r/MadeOfhuman figure
herself	/r/MadeOf 	herself /r/MadeOfmythical character
himself	/r/MadeOf 	himself /r/MadeOftheatrical profession
his	/r/MadeOf 	his /r/MadeOfmuseum
woman	/r/MadeOf 	woman /r/MadeOfmale human
man	/r/MadeOf 	man /r/MadeOfposition
female	/r/MadeOf 	female /r/MadeOfhuman
male	/r/MadeOf 	male /r/MadeOfmilitary rank
lady	/r/MadeOf 	lady /r/MadeOfmural
gentleman	/r/MadeOf 	gentleman /r/MadeOfscholar
ladies	/r/MadeOf 	ladies /r/MadeOfsports terminology
gentlemen	/r/MadeOf 	gentlemen /r/MadeOfgentlemen
girl	/r/MadeOf 	girl /r/MadeOfsexual activity
boy	/r/MadeOf 	boy /r/MadeOfhuman figure
sir	/r/MadeOf 	sir /r/MadeOfhuman activity
ma am	/r/MadeOf 	ma am /r/MadeOfmusic genre
mother	/r/MadeOf 	mother /r/MadeOfgoddess
father	/r/MadeOf 	father /r/MadeOfsister
stepmother	/r/MadeOf 	stepmother /r/MadeOfniece-in-law
stepfather	/r/MadeOf 	stepfather /r/MadeOfbirth attendant
daughter	/r/MadeOf 	daughter /r/MadeOfperson of interest
son	/r/MadeOf 	son /r/MadeOfmusical character
sister	/r/MadeOf 	sister /r/MadeOfkinship
brother	/r/MadeOf 	brother /r/MadeOfposition
grandmother	/r/MadeOf 	grandmother /r/MadeOfgrandmother
grandfather	/r/MadeOf 	grandfather /r/MadeOfgrandmother
mommy	/r/MadeOf 	mommy /r/MadeOfsexual activity
daddy	/r/MadeOf 	daddy /r/MadeOfdiplomatic rank
wife	/r/MadeOf 	wife /r/MadeOfwife relationship
husband	/r/MadeOf 	husband /r/MadeOfmale-female sexual behavior
bride	/r/MadeOf 	bride /r/MadeOfcrowdfunding
groom	/r/MadeOf 	groom /r/MadeOfbuilding component
girlfriend	/r/MadeOf 	girlfriend /r/MadeOfpersonality type
boyfriend	/r/MadeOf 	boyfriend /r/MadeOfbrother-in-law
schoolgirl	/r/MadeOf 	schoolgirl /r/MadeOftelevision program
schoolboy	/r/MadeOf 	schoolboy /r/MadeOfsister or kinship
sharia	/r/MadeOf 	sharia /r/MadeOfsharia
jihad	/r/MadeOf 	jihad /r/MadeOfwarfare
christian	/r/MadeOf 	christian /r/MadeOfcultural identity
muslim	/r/MadeOf 	muslim /r/MadeOfmusical instrument
islam	/r/MadeOf 	islam /r/MadeOfpride
hindu	/r/MadeOf 	hindu /r/MadeOfhistorical profession
mohammed	/r/MadeOf 	mohammed /r/MadeOfsmuggler
church	/r/MadeOf 	church /r/MadeOfmilitary operation
quran	/r/MadeOf 	quran /r/MadeOfmarihana
bible	/r/MadeOf 	bible /r/MadeOfcatholic
brahmin	/r/MadeOf 	brahmin /r/MadeOfsiren
holy trinity	/r/MadeOf 	holy trinity /r/MadeOfphilosophical concept
barber	/r/MadeOf 	barber /r/MadeOfbarber
coach	/r/MadeOf 	coach /r/MadeOfbacon dish
businessperson	/r/MadeOf 	businessperson /r/MadeOffinancial consultant
football player	/r/MadeOf 	football player /r/MadeOffootball player
construction worker	/r/MadeOf 	construction worker /r/MadeOfconstruction worker
manager	/r/MadeOf 	manager /r/MadeOffictional government agency
ceo	/r/MadeOf 	ceo /r/MadeOfpsychology terminology
accountant	/r/MadeOf 	accountant /r/MadeOfaccountant
commander	/r/MadeOf 	commander /r/MadeOfcommander
firefighter	/r/MadeOf 	firefighter /r/MadeOfaircraft component
mover	/r/MadeOf 	mover /r/MadeOfmansion
software developer	/r/MadeOf 	software developer /r/MadeOfsoftware development manager
guard	/r/MadeOf 	guard /r/MadeOfguard
baker	/r/MadeOf 	baker /r/MadeOfcooking oil
doctor	/r/MadeOf 	doctor /r/MadeOfoccupation
athlete	/r/MadeOf 	athlete /r/MadeOfathlete
artist	/r/MadeOf 	artist /r/MadeOfartist
dancer	/r/MadeOf 	dancer /r/MadeOfhymn for a dance
mathematician	/r/MadeOf 	mathematician /r/MadeOfmathematical sciences
janitor	/r/MadeOf 	janitor /r/MadeOfpublic prosecutor
carpenter	/r/MadeOf 	carpenter /r/MadeOfcorporate title
mechanic	/r/MadeOf 	mechanic /r/MadeOfphysical phenomenon
actor	/r/MadeOf 	actor /r/MadeOffilm character
handyman	/r/MadeOf 	handyman /r/MadeOfoccupation
musician	/r/MadeOf 	musician /r/MadeOfmusician
detective	/r/MadeOf 	detective /r/MadeOfdetective
politician	/r/MadeOf 	politician /r/MadeOfacademic
entrepreneur	/r/MadeOf 	entrepreneur /r/MadeOfsocial interaction
model	/r/MadeOf 	model /r/MadeOfmusic genre
opera singer	/r/MadeOf 	opera singer /r/MadeOfoccupation
chief	/r/MadeOf 	chief /r/MadeOfchief of staff
lawyer	/r/MadeOf 	lawyer /r/MadeOflawyer
farmer	/r/MadeOf 	farmer /r/MadeOfoccupation
writer	/r/MadeOf 	writer /r/MadeOfoccupation
librarian	/r/MadeOf 	librarian /r/MadeOflibrarian service
army	/r/MadeOf 	army /r/MadeOfmilitary unit type class
real estate developer	/r/MadeOf 	real estate developer /r/MadeOfresidence property developer
broker	/r/MadeOf 	broker /r/MadeOfbusinessperson
scientist	/r/MadeOf 	scientist /r/MadeOfscholar
butcher	/r/MadeOf 	butcher /r/MadeOffood product
electrician	/r/MadeOf 	electrician /r/MadeOfmusical profession
prosecutor	/r/MadeOf 	prosecutor /r/MadeOfprosecutor
banker	/r/MadeOf 	banker /r/MadeOfarchitectural designer
cook	/r/MadeOf 	cook /r/MadeOfcooking oil
hairdresser	/r/MadeOf 	hairdresser /r/MadeOffacial artist
prisoner	/r/MadeOf 	prisoner /r/MadeOfprisoners of conscience
plumber	/r/MadeOf 	plumber /r/MadeOfplaster
attorney	/r/MadeOf 	attorney /r/MadeOfattorney
boxer	/r/MadeOf 	boxer /r/MadeOfmusic writer
chess player	/r/MadeOf 	chess player /r/MadeOfplayer
priest	/r/MadeOf 	priest /r/MadeOfcounselor
swimmer	/r/MadeOf 	swimmer /r/MadeOfswimwear
tennis player	/r/MadeOf 	tennis player /r/MadeOftennis terminology
supervisor	/r/MadeOf 	supervisor /r/MadeOfoccupation
attendant	/r/MadeOf 	attendant /r/MadeOfposition
housekeeper	/r/MadeOf 	housekeeper /r/MadeOfkeeper
maid	/r/MadeOf 	maid /r/MadeOfoccupation
producer	/r/MadeOf 	producer /r/MadeOfdevice
researcher	/r/MadeOf 	researcher /r/MadeOfresearcher
midwife	/r/MadeOf 	midwife /r/MadeOfmidwife
judge	/r/MadeOf 	judge /r/MadeOflegal process
umpire	/r/MadeOf 	umpire /r/MadeOfmotorcycle component
bartender	/r/MadeOf 	bartender /r/MadeOfpoultry feed
economist	/r/MadeOf 	economist /r/MadeOfoccupation
physicist	/r/MadeOf 	physicist /r/MadeOfacademic
psychologist	/r/MadeOf 	psychologist /r/MadeOfpsychologist
theologian	/r/MadeOf 	theologian /r/MadeOfmythical figure
salesperson	/r/MadeOf 	salesperson /r/MadeOfperson
physician	/r/MadeOf 	physician /r/MadeOfmedicine
sheriff	/r/MadeOf 	sheriff /r/MadeOfdeputy
cashier	/r/MadeOf 	cashier /r/MadeOfaccountant
assistant	/r/MadeOf 	assistant /r/MadeOfhead
receptionist	/r/MadeOf 	receptionist /r/MadeOfpolitical activist
editor	/r/MadeOf 	editor /r/MadeOfeditor
engineer	/r/MadeOf 	engineer /r/MadeOfcoffee-making process
comedian	/r/MadeOf 	comedian /r/MadeOfcomedic
painter	/r/MadeOf 	painter /r/MadeOfpainting tool
civil servant	/r/MadeOf 	civil servant /r/MadeOfcivil unit
diplomat	/r/MadeOf 	diplomat /r/MadeOfdiplomat
guitarist	/r/MadeOf 	guitarist /r/MadeOfguitarist
linguist	/r/MadeOf 	linguist /r/MadeOfoccupation
poet	/r/MadeOf 	poet /r/MadeOfmusic term
laborer	/r/MadeOf 	laborer /r/MadeOfoccupation
teacher	/r/MadeOf 	teacher /r/MadeOfteacher profession
delivery man	/r/MadeOf 	delivery man /r/MadeOfdelivery services
realtor	/r/MadeOf 	realtor /r/MadeOfoccupation
pilot	/r/MadeOf 	pilot /r/MadeOfmusical profession
professor	/r/MadeOf 	professor /r/MadeOfacademic
chemist	/r/MadeOf 	chemist /r/MadeOfphilosophical scholar
historian	/r/MadeOf 	historian /r/MadeOfhistorical profession
pensioner	/r/MadeOf 	pensioner /r/MadeOfadministrator
performing artist	/r/MadeOf 	performing artist /r/MadeOfcreative work type
singer	/r/MadeOf 	singer /r/MadeOfsnooker
secretary	/r/MadeOf 	secretary /r/MadeOfaccountant
auditor	/r/MadeOf 	auditor /r/MadeOfauditor
counselor	/r/MadeOf 	counselor /r/MadeOflegal professional
designer	/r/MadeOf 	designer /r/MadeOfposition
soldier	/r/MadeOf 	soldier /r/MadeOfcommander
journalist	/r/MadeOf 	journalist /r/MadeOfjournalist
dentist	/r/MadeOf 	dentist /r/MadeOfoccupation
analyst	/r/MadeOf 	analyst /r/MadeOfsocial scientist
nurse	/r/MadeOf 	nurse /r/MadeOfoccupation
tailor	/r/MadeOf 	tailor /r/MadeOfgeologist
waiter	/r/MadeOf 	waiter /r/MadeOfpassenger
author	/r/MadeOf 	author /r/MadeOfoccupation
architect	/r/MadeOf 	architect /r/MadeOfarchitectural element of a building
academic	/r/MadeOf 	academic /r/MadeOfacademic
director	/r/MadeOf 	director /r/MadeOfposition
illustrator	/r/MadeOf 	illustrator /r/MadeOfposition
clerk	/r/MadeOf 	clerk /r/MadeOfclimbing device
policeman	/r/MadeOf 	policeman /r/MadeOfoccupation
chef	/r/MadeOf 	chef /r/MadeOfchef
photographer	/r/MadeOf 	photographer /r/MadeOfphotographer
drawer	/r/MadeOf 	drawer /r/MadeOfdrawer
cleaner	/r/MadeOf 	cleaner /r/MadeOfgarden decoration
pharmacist	/r/MadeOf 	pharmacist /r/MadeOfhealth professional
pianist	/r/MadeOf 	pianist /r/MadeOfmusical profession
composer	/r/MadeOf 	composer /r/MadeOfoccupation
handball player	/r/MadeOf 	handball player /r/MadeOfbodyweight class
sociologist	/r/MadeOf 	sociologist /r/MadeOfoccupation
african american	/r/HasProperty 	african american /r/HasPropertyabandoned country
armenian	/r/HasProperty 	armenian /r/HasPropertymilitary officer
persian	/r/HasProperty 	persian /r/HasPropertysamba
american	/r/HasProperty 	american /r/HasPropertyamerican-only sports
filipino	/r/HasProperty 	filipino /r/HasPropertymusical instrument instrument family
english	/r/HasProperty 	english /r/HasPropertynouns
norwegian	/r/HasProperty 	norwegian /r/HasPropertymixed country
dutch	/r/HasProperty 	dutch /r/HasPropertytense
israeli	/r/HasProperty 	israeli /r/HasPropertynational anthem
nigerian	/r/HasProperty 	nigerian /r/HasPropertynational title
ethiopia	/r/HasProperty 	ethiopia /r/HasPropertyhypothetical entity
europe	/r/HasProperty 	europe /r/HasPropertyparallel series
european	/r/HasProperty 	european /r/HasPropertysemi-colony
russian	/r/HasProperty 	russian /r/HasPropertyrussian
ukraine	/r/HasProperty 	ukraine /r/HasPropertyvacation
sudan	/r/HasProperty 	sudan /r/HasPropertysouthern cousin
afghanistan	/r/HasProperty 	afghanistan /r/HasPropertynorthern republic
iraq	/r/HasProperty 	iraq /r/HasPropertyreligious terminology
yemen	/r/HasProperty 	yemen /r/HasPropertyconfederacy
ukrainian	/r/HasProperty 	ukrainian /r/HasPropertycanarian and other languages /r/canary
russia	/r/HasProperty 	russia /r/HasPropertywelfare queen
italy	/r/HasProperty 	italy /r/HasPropertysoutheast
somali	/r/HasProperty 	somali /r/HasPropertysomalian
iran	/r/HasProperty 	iran /r/HasPropertyarchaeologist
afghan	/r/HasProperty 	afghan /r/HasPropertyindigenous peoples
indian	/r/HasProperty 	indian /r/HasPropertyindigenous character
italian	/r/HasProperty 	italian /r/HasPropertyinherited language
australian	/r/HasProperty 	australian /r/HasPropertybilingualism
spanish	/r/HasProperty 	spanish /r/HasPropertysnarfish
guatemalan	/r/HasProperty 	guatemalan /r/HasPropertyguerrilla
hispanic	/r/HasProperty 	hispanic /r/HasPropertydisorder of taste
venezuela	/r/HasProperty 	venezuela /r/HasPropertyculin
sudanese	/r/HasProperty 	sudanese /r/HasPropertyislet of Sudanese
oman	/r/HasProperty 	oman /r/HasPropertyarchitecture terminology
finnish	/r/HasProperty 	finnish /r/HasPropertyfinnish population
swedish	/r/HasProperty 	swedish /r/HasPropertymusic genre
venezuelan	/r/HasProperty 	venezuelan /r/HasPropertyoccupation
puerto rican	/r/HasProperty 	puerto rican /r/HasPropertygeographic marker
ghanaian	/r/HasProperty 	ghanaian /r/HasPropertymusical family
moroccan	/r/HasProperty 	moroccan /r/HasPropertybiblical deity
somalia	/r/HasProperty 	somalia /r/HasPropertysomalia
saudi arabian	/r/HasProperty 	saudi arabian /r/HasPropertysaudi music
syria	/r/HasProperty 	syria /r/HasPropertygeological phenomenon
chinese	/r/HasProperty 	chinese /r/HasPropertycattle breed
pakistani	/r/HasProperty 	pakistani /r/HasPropertyfascism
china	/r/HasProperty 	china /r/HasPropertychinese dish
india	/r/HasProperty 	india /r/HasPropertyindigenous
irish	/r/HasProperty 	irish /r/HasPropertynursery
britain	/r/HasProperty 	britain /r/HasPropertybadminton match
france	/r/HasProperty 	france /r/HasPropertyfrance
greece	/r/HasProperty 	greece /r/HasPropertycompound economic branch
scotland	/r/HasProperty 	scotland /r/HasPropertylandscape
mexican	/r/HasProperty 	mexican /r/HasPropertymexican dish
paraguayan	/r/HasProperty 	paraguayan /r/HasPropertyparaguas
brazil	/r/HasProperty 	brazil /r/HasPropertyterritorial entity
african	/r/HasProperty 	african /r/HasPropertyacademic
eritrean	/r/HasProperty 	eritrean /r/HasPropertygroup of organisms known by one particular common name
sierra leonean	/r/HasProperty 	sierra leonean /r/HasPropertyleone
africa	/r/HasProperty 	africa /r/HasPropertyfarewell
jordan	/r/HasProperty 	jordan /r/HasPropertydwarf
indonesia	/r/HasProperty 	indonesia /r/HasPropertyindigenous culture
vietnam	/r/HasProperty 	vietnam /r/HasPropertyterritorial entity
pakistan	/r/HasProperty 	pakistan /r/HasPropertysyndicate
german	/r/HasProperty 	german /r/HasPropertygeographic feature
romania	/r/HasProperty 	romania /r/HasPropertyhuman drama
brazilian	/r/HasProperty 	brazilian /r/HasPropertybrazilian cuisine
ecuadorian	/r/HasProperty 	ecuadorian /r/HasPropertyequestrian discipline
mexico	/r/HasProperty 	mexico /r/HasPropertyalbum material
puerto rico	/r/HasProperty 	puerto rico /r/HasPropertypiano complex
kenyan	/r/HasProperty 	kenyan /r/HasPropertymixture
liberian	/r/HasProperty 	liberian /r/HasPropertylibertarian
cameroonian	/r/HasProperty 	cameroonian /r/HasPropertygolf course
african americans	/r/HasProperty 	african americans /r/HasPropertyafrican african americans
kenya	/r/HasProperty 	kenya /r/HasPropertyyogurt
liberia	/r/HasProperty 	liberia /r/HasPropertyliberty
sierra leon	/r/HasProperty 	sierra leon /r/HasPropertyjungle
qatari	/r/HasProperty 	qatari /r/HasPropertyoccupation
syrian	/r/HasProperty 	syrian /r/HasPropertyisland
arab	/r/HasProperty 	arab /r/HasPropertypest management
saudi arabia	/r/HasProperty 	saudi arabia /r/HasPropertysaudi bistro
lebanon	/r/HasProperty 	lebanon /r/HasPropertysalad
indonesian	/r/HasProperty 	indonesian /r/HasPropertyindicator
french	/r/HasProperty 	french /r/HasPropertycricket
norwegian	/r/HasProperty 	norwegian /r/HasPropertyneighbor
south africa	/r/HasProperty 	south africa /r/HasPropertyurban regions
jordanian	/r/HasProperty 	jordanian /r/HasPropertyjacket
korea	/r/HasProperty 	korea /r/HasPropertysouthern hemisphere
singapore	/r/HasProperty 	singapore /r/HasPropertymeteorological region
romanian	/r/HasProperty 	romanian /r/HasPropertymuscular biology
crimean	/r/HasProperty 	crimean /r/HasPropertyhuman rights activist
native american	/r/HasProperty 	native american /r/HasPropertynative american
germany	/r/HasProperty 	germany /r/HasPropertyagreement
ireland	/r/HasProperty 	ireland /r/HasPropertyhistorical entity
ecuador	/r/HasProperty 	ecuador /r/HasPropertye-book
morocco	/r/HasProperty 	morocco /r/HasPropertycellular anatomical entity
omani	/r/HasProperty 	omani /r/HasPropertyanimal model
iranian	/r/HasProperty 	iranian /r/HasPropertydistant human
iraqi	/r/HasProperty 	iraqi /r/HasPropertynatural martial arts term
qatar	/r/HasProperty 	qatar /r/HasPropertypolitical concept
turkey	/r/HasProperty 	turkey /r/HasPropertyturkey dish
vietnamese	/r/HasProperty 	vietnamese /r/HasPropertyvegetation
nepali	/r/HasProperty 	nepali /r/HasPropertymythical creature
laos	/r/HasProperty 	laos /r/HasPropertyplaid
bangladesh	/r/HasProperty 	bangladesh /r/HasPropertylatin
british	/r/HasProperty 	british /r/HasPropertybritish translation
polish	/r/HasProperty 	polish /r/HasPropertywoven fabric
greek	/r/HasProperty 	greek /r/HasPropertymusical instrument design
scottish	/r/HasProperty 	scottish /r/HasPropertyplaying card
bolivian	/r/HasProperty 	bolivian /r/HasPropertyconvergence
guatemala	/r/HasProperty 	guatemala /r/HasPropertyguatemale
ghana	/r/HasProperty 	ghana /r/HasPropertysnow cover
cameroon	/r/HasProperty 	cameroon /r/HasPropertycameroon ship
japanese	/r/HasProperty 	japanese /r/HasPropertyjapanese language
taiwanese	/r/HasProperty 	taiwanese /r/HasPropertytaiwanese community
bengali	/r/HasProperty 	bengali /r/HasPropertysoup food
nepal	/r/HasProperty 	nepal /r/HasPropertycavity
albanian	/r/HasProperty 	albanian /r/HasPropertyalbanian
albania	/r/HasProperty 	albania /r/HasPropertyalbania
columbian	/r/HasProperty 	columbian /r/HasPropertycubic language
peruvian	/r/HasProperty 	peruvian /r/HasPropertycocoa-ceremonial hair
argentian	/r/HasProperty 	argentian /r/HasPropertybranch of physics
spain	/r/HasProperty 	spain /r/HasPropertyaccidental trauma
paraguay	/r/HasProperty 	paraguay /r/HasPropertyparagoun
ethiopian	/r/HasProperty 	ethiopian /r/HasPropertyphilosophical movement
egyptian	/r/HasProperty 	egyptian /r/HasPropertymixed-sex intercourse
persian people	/r/HasProperty 	persian people /r/HasPropertypersian
sweden	/r/HasProperty 	sweden /r/HasPropertywelfare country
crimea	/r/HasProperty 	crimea /r/HasPropertycrime
portuguese	/r/HasProperty 	portuguese /r/HasPropertytort
argentina	/r/HasProperty 	argentina /r/HasPropertystate
chile	/r/HasProperty 	chile /r/HasPropertychile peppers
cape verdean	/r/HasProperty 	cape verdean /r/HasPropertyvocal sound
turkish	/r/HasProperty 	turkish /r/HasPropertyturkish ideology
yemeni	/r/HasProperty 	yemeni /r/HasPropertyyouth
taiwan	/r/HasProperty 	taiwan /r/HasPropertynautical term
austrian	/r/HasProperty 	austrian /r/HasPropertybird of a species
white people	/r/HasProperty 	white people /r/HasPropertywhite nationalism
finland	/r/HasProperty 	finland /r/HasPropertybondage
australia	/r/HasProperty 	australia /r/HasPropertybirth
south african	/r/HasProperty 	south african /r/HasPropertycentral african
eriteria	/r/HasProperty 	eriteria /r/HasPropertypsychology terminology
egypt	/r/HasProperty 	egypt /r/HasPropertyegyptology
korean	/r/HasProperty 	korean /r/HasPropertytype of chemical compound
dutch people	/r/HasProperty 	dutch people /r/HasPropertynude culture
peru	/r/HasProperty 	peru /r/HasPropertyacademic rank
poland	/r/HasProperty 	poland /r/HasPropertypsychology terminology
chilean	/r/HasProperty 	chilean /r/HasPropertygrit and pepper soup
columbia	/r/HasProperty 	columbia /r/HasPropertycentral part of the abdomen
bolivia	/r/HasProperty 	bolivia /r/HasPropertybelize
laotian	/r/HasProperty 	laotian /r/HasPropertysouthern hemisphere
lebanese	/r/HasProperty 	lebanese /r/HasPropertyrice dish
japan	/r/HasProperty 	japan /r/HasPropertyartistic technique
norway	/r/HasProperty 	norway /r/HasPropertytunnel
cape verde	/r/HasProperty 	cape verde /r/HasPropertycotton
portugal	/r/HasProperty 	portugal /r/HasPropertyvoting machine
austria	/r/HasProperty 	austria /r/HasPropertymusic genre
singaporean	/r/HasProperty 	singaporean /r/HasPropertychinese
netherlands	/r/HasProperty 	netherlands /r/HasPropertyterritoriality
she	/r/HasProperty 	she /r/HasPropertynervous system disease
he	/r/HasProperty 	he /r/HasPropertymechanic
hers	/r/HasProperty 	hers /r/HasPropertybicycle parts
him	/r/HasProperty 	him /r/HasPropertysibling
her	/r/HasProperty 	her /r/HasPropertyhead
herself	/r/HasProperty 	herself /r/HasPropertyhuman object
himself	/r/HasProperty 	himself /r/HasPropertyindividual or class of organisms
his	/r/HasProperty 	his /r/HasPropertypsychology terminology
woman	/r/HasProperty 	woman /r/HasPropertyfictional human
man	/r/HasProperty 	man /r/HasPropertywrestling video game
female	/r/HasProperty 	female /r/HasPropertyhuman
male	/r/HasProperty 	male /r/HasPropertyfemale characters
lady	/r/HasProperty 	lady /r/HasPropertylady
gentleman	/r/HasProperty 	gentleman /r/HasPropertyoccupation
ladies	/r/HasProperty 	ladies /r/HasPropertysports discipline
gentlemen	/r/HasProperty 	gentlemen /r/HasPropertyphilosophical social concept
girl	/r/HasProperty 	girl /r/HasPropertymale character
boy	/r/HasProperty 	boy /r/HasPropertylaptop
sir	/r/HasProperty 	sir /r/HasPropertygeographic features
ma am	/r/HasProperty 	ma am /r/HasPropertymascot in literature
mother	/r/HasProperty 	mother /r/HasPropertyheritage preservation
father	/r/HasProperty 	father /r/HasPropertyfather
stepmother	/r/HasProperty 	stepmother /r/HasPropertyfacial-pattern representation
stepfather	/r/HasProperty 	stepfather /r/HasPropertycousin
daughter	/r/HasProperty 	daughter /r/HasPropertyfemale pronoun
son	/r/HasProperty 	son /r/HasPropertykinship
sister	/r/HasProperty 	sister /r/HasPropertysister
brother	/r/HasProperty 	brother /r/HasPropertybrother
grandmother	/r/HasProperty 	grandmother /r/HasPropertysister
grandfather	/r/HasProperty 	grandfather /r/HasPropertygrandfather
mommy	/r/HasProperty 	mommy /r/HasPropertymommy
daddy	/r/HasProperty 	daddy /r/HasPropertyadversary
wife	/r/HasProperty 	wife /r/HasPropertyfictional human
husband	/r/HasProperty 	husband /r/HasPropertyhusband\'s son
bride	/r/HasProperty 	bride /r/HasPropertyshipping container
groom	/r/HasProperty 	groom /r/HasPropertyhuman figure
girlfriend	/r/HasProperty 	girlfriend /r/HasPropertyfamily member
boyfriend	/r/HasProperty 	boyfriend /r/HasPropertyboyfriend
schoolgirl	/r/HasProperty 	schoolgirl /r/HasPropertysports discipline
schoolboy	/r/HasProperty 	schoolboy /r/HasPropertyschool age
sharia	/r/HasProperty 	sharia /r/HasPropertyreligious terminology
jihad	/r/HasProperty 	jihad /r/HasPropertymusical arrangement
christian	/r/HasProperty 	christian /r/HasPropertychristianism
muslim	/r/HasProperty 	muslim /r/HasPropertymusculosomatic body part
islam	/r/HasProperty 	islam /r/HasPropertyoccupation
hindu	/r/HasProperty 	hindu /r/HasPropertyphilosophical subtext
mohammed	/r/HasProperty 	mohammed /r/HasPropertywet blanket
church	/r/HasProperty 	church /r/HasPropertychurch building
quran	/r/HasProperty 	quran /r/HasPropertyzrânau
bible	/r/HasProperty 	bible /r/HasPropertybiblical translation
brahmin	/r/HasProperty 	brahmin /r/HasPropertybrahmin
holy trinity	/r/HasProperty 	holy trinity /r/HasPropertysymbol
barber	/r/HasProperty 	barber /r/HasPropertybarber
coach	/r/HasProperty 	coach /r/HasPropertyanimal care
businessperson	/r/HasProperty 	businessperson /r/HasPropertyelectrical technician
football player	/r/HasProperty 	football player /r/HasPropertysports major
construction worker	/r/HasProperty 	construction worker /r/HasPropertyconstruction worker
manager	/r/HasProperty 	manager /r/HasPropertyconsultant
ceo	/r/HasProperty 	ceo /r/HasPropertyphilosophy of chemistry
accountant	/r/HasProperty 	accountant /r/HasPropertybank account
commander	/r/HasProperty 	commander /r/HasPropertymilitary rank
firefighter	/r/HasProperty 	firefighter /r/HasPropertyflying-type aircraft
mover	/r/HasProperty 	mover /r/HasPropertymachine learning
software developer	/r/HasProperty 	software developer /r/HasPropertycomputer programmer
guard	/r/HasProperty 	guard /r/HasPropertymixed martial arts training
baker	/r/HasProperty 	baker /r/HasPropertycattle meat
doctor	/r/HasProperty 	doctor /r/HasPropertyphilosophical concept
athlete	/r/HasProperty 	athlete /r/HasPropertyathletic specialist
artist	/r/HasProperty 	artist /r/HasPropertyposition
dancer	/r/HasProperty 	dancer /r/HasPropertydancer
mathematician	/r/HasProperty 	mathematician /r/HasPropertycomputer art type
janitor	/r/HasProperty 	janitor /r/HasPropertylegal human relationship
carpenter	/r/HasProperty 	carpenter /r/HasPropertymilitary rank
mechanic	/r/HasProperty 	mechanic /r/HasPropertypsychology terminology
actor	/r/HasProperty 	actor /r/HasPropertyarchitectural engineer
handyman	/r/HasProperty 	handyman /r/HasPropertycoke and alcohol policy
musician	/r/HasProperty 	musician /r/HasPropertymusical group
detective	/r/HasProperty 	detective /r/HasPropertydetective
politician	/r/HasProperty 	politician /r/HasPropertyposition
entrepreneur	/r/HasProperty 	entrepreneur /r/HasPropertyoccupation
model	/r/HasProperty 	model /r/HasPropertyacademic major
opera singer	/r/HasProperty 	opera singer /r/HasPropertymusical composition
chief	/r/HasProperty 	chief /r/HasPropertyposition
lawyer	/r/HasProperty 	lawyer /r/HasPropertylegal professional
farmer	/r/HasProperty 	farmer /r/HasPropertyage 18
writer	/r/HasProperty 	writer /r/HasPropertyscholarly article
librarian	/r/HasProperty 	librarian /r/HasPropertymagazines and
army	/r/HasProperty 	army /r/HasPropertyarmy
real estate developer	/r/HasProperty 	real estate developer /r/HasPropertyreal estate consultant
broker	/r/HasProperty 	broker /r/HasPropertybroker
scientist	/r/HasProperty 	scientist /r/HasPropertypsychologist
butcher	/r/HasProperty 	butcher /r/HasPropertyshrimp sauce
electrician	/r/HasProperty 	electrician /r/HasPropertyartistic design
prosecutor	/r/HasProperty 	prosecutor /r/HasPropertycivil sentence
banker	/r/HasProperty 	banker /r/HasPropertybanker
cook	/r/HasProperty 	cook /r/HasPropertymachine-readable medium
hairdresser	/r/HasProperty 	hairdresser /r/HasPropertyhair ornament
prisoner	/r/HasProperty 	prisoner /r/HasPropertyprisoner-child ratio
plumber	/r/HasProperty 	plumber /r/HasPropertymusical profession
attorney	/r/HasProperty 	attorney /r/HasPropertyconsultant
boxer	/r/HasProperty 	boxer /r/HasPropertyship type
chess player	/r/HasProperty 	chess player /r/HasPropertychess term
priest	/r/HasProperty 	priest /r/HasPropertypriestess
swimmer	/r/HasProperty 	swimmer /r/HasPropertybomber
tennis player	/r/HasProperty 	tennis player /r/HasPropertyoccupation
supervisor	/r/HasProperty 	supervisor /r/HasPropertyemployee
attendant	/r/HasProperty 	attendant /r/HasPropertyoccupation
housekeeper	/r/HasProperty 	housekeeper /r/HasPropertyoccupation
maid	/r/HasProperty 	maid /r/HasPropertyhumanoid
producer	/r/HasProperty 	producer /r/HasPropertymanufacturer
researcher	/r/HasProperty 	researcher /r/HasPropertyresearcher
midwife	/r/HasProperty 	midwife /r/HasPropertycousin
judge	/r/HasProperty 	judge /r/HasPropertyjudgment
umpire	/r/HasProperty 	umpire /r/HasPropertyconstruction tool
bartender	/r/HasProperty 	bartender /r/HasPropertyoccupation
economist	/r/HasProperty 	economist /r/HasPropertypolitical activist
physicist	/r/HasProperty 	physicist /r/HasPropertyastronomical profession
psychologist	/r/HasProperty 	psychologist /r/HasPropertyhypothetical human
theologian	/r/HasProperty 	theologian /r/HasPropertymythical character
salesperson	/r/HasProperty 	salesperson /r/HasPropertyoccupation
physician	/r/HasProperty 	physician /r/HasPropertymedical specialty
sheriff	/r/HasProperty 	sheriff /r/HasPropertyhusband
cashier	/r/HasProperty 	cashier /r/HasPropertypayment
assistant	/r/HasProperty 	assistant /r/HasPropertyassistant
receptionist	/r/HasProperty 	receptionist /r/HasPropertyhuman activity
editor	/r/HasProperty 	editor /r/HasPropertyeditor
engineer	/r/HasProperty 	engineer /r/HasPropertyhuman resource management
comedian	/r/HasProperty 	comedian /r/HasPropertycomedic role
painter	/r/HasProperty 	painter /r/HasPropertypainting material
civil servant	/r/HasProperty 	civil servant /r/HasPropertyhuman
diplomat	/r/HasProperty 	diplomat /r/HasPropertydiplomatic mission
guitarist	/r/HasProperty 	guitarist /r/HasPropertyoccupation
linguist	/r/HasProperty 	linguist /r/HasPropertyoccupation
poet	/r/HasProperty 	poet /r/HasPropertytote (platter
laborer	/r/HasProperty 	laborer /r/HasPropertylegal theorist
teacher	/r/HasProperty 	teacher /r/HasPropertyadministrator
delivery man	/r/HasProperty 	delivery man /r/HasPropertyde-identifier
realtor	/r/HasProperty 	realtor /r/HasPropertyoccupation
pilot	/r/HasProperty 	pilot /r/HasPropertyoccupation
professor	/r/HasProperty 	professor /r/HasPropertyacademic
chemist	/r/HasProperty 	chemist /r/HasPropertyarchitectural element
historian	/r/HasProperty 	historian /r/HasPropertyhistorical figure
pensioner	/r/HasProperty 	pensioner /r/HasPropertyoccupation
performing artist	/r/HasProperty 	performing artist /r/HasPropertyoccupation
singer	/r/HasProperty 	singer /r/HasPropertypiano player
secretary	/r/HasProperty 	secretary /r/HasPropertyofficial
auditor	/r/HasProperty 	auditor /r/HasPropertyauditor
counselor	/r/HasProperty 	counselor /r/HasPropertylegal professional
designer	/r/HasProperty 	designer /r/HasPropertydesigner of music
soldier	/r/HasProperty 	soldier /r/HasPropertyoccupation
journalist	/r/HasProperty 	journalist /r/HasPropertyjournalist
dentist	/r/HasProperty 	dentist /r/HasPropertysurgical technique
analyst	/r/HasProperty 	analyst /r/HasPropertyanalytical discipline
nurse	/r/HasProperty 	nurse /r/HasPropertydental surgeon
tailor	/r/HasProperty 	tailor /r/HasPropertyhead
waiter	/r/HasProperty 	waiter /r/HasPropertyconsultant
author	/r/HasProperty 	author /r/HasPropertyeducator
architect	/r/HasProperty 	architect /r/HasPropertyarchitectural style
academic	/r/HasProperty 	academic /r/HasPropertyposition
director	/r/HasProperty 	director /r/HasPropertycoordination
illustrator	/r/HasProperty 	illustrator /r/HasPropertysoftware engineer
clerk	/r/HasProperty 	clerk /r/HasPropertyfish cocktail
policeman	/r/HasProperty 	policeman /r/HasPropertycivil and political rights activist
chef	/r/HasProperty 	chef /r/HasPropertychef
photographer	/r/HasProperty 	photographer /r/HasPropertyphotographer
drawer	/r/HasProperty 	drawer /r/HasPropertydrawer
cleaner	/r/HasProperty 	cleaner /r/HasPropertymixture
pharmacist	/r/HasProperty 	pharmacist /r/HasPropertyphilosophy of science
pianist	/r/HasProperty 	pianist /r/HasPropertyoccupation
composer	/r/HasProperty 	composer /r/HasPropertyproposer
handball player	/r/HasProperty 	handball player /r/HasPropertybody sport
sociologist	/r/HasProperty 	sociologist /r/HasPropertyhistorical profession
african american	/r/Causes 	african american /r/Causesapal
armenian	/r/Causes 	armenian /r/Causesalpine
persian	/r/Causes 	persian /r/Causesmolecular entity
american	/r/Causes 	american /r/Causesmigration
filipino	/r/Causes 	filipino /r/Causesfilmmaking film
english	/r/Causes 	english /r/Causesmusic term
norwegian	/r/Causes 	norwegian /r/Causeslanguage barrier
dutch	/r/Causes 	dutch /r/Causesvacation
israeli	/r/Causes 	israeli /r/Causesaspect of geometry
nigerian	/r/Causes 	nigerian /r/Causesbiblical occupation
ethiopia	/r/Causes 	ethiopia /r/Causesmedical terminology
europe	/r/Causes 	europe /r/Causescricket
european	/r/Causes 	european /r/Causesglobal economy
russian	/r/Causes 	russian /r/Causesscholarly article
ukraine	/r/Causes 	ukraine /r/Causesvietnamese
sudan	/r/Causes 	sudan /r/Causessudan
afghanistan	/r/Causes 	afghanistan /r/Causesoccupation
iraq	/r/Causes 	iraq /r/Causesyosem cheese
yemen	/r/Causes 	yemen /r/Causeswar of attrition
ukrainian	/r/Causes 	ukrainian /r/Causespink
russia	/r/Causes 	russia /r/Causesrussia
italy	/r/Causes 	italy /r/Causesitaly
somali	/r/Causes 	somali /r/Causessomali
iran	/r/Causes 	iran /r/Causessouthernmost territorial entity
afghan	/r/Causes 	afghan /r/Causesfilmmaking occupation
indian	/r/Causes 	indian /r/Causesindian-themed music
italian	/r/Causes 	italian /r/Causesassociation
australian	/r/Causes 	australian /r/Causesbirthright
spanish	/r/Causes 	spanish /r/Causescinema
guatemalan	/r/Causes 	guatemalan /r/Causesguamish
hispanic	/r/Causes 	hispanic /r/Causeseconomic concept
venezuela	/r/Causes 	venezuela /r/Causesscholarly article
sudanese	/r/Causes 	sudanese /r/Causesnorthern forest
oman	/r/Causes 	oman /r/Causesmute
finnish	/r/Causes 	finnish /r/Causesfictional country
swedish	/r/Causes 	swedish /r/Causesswim movement
venezuelan	/r/Causes 	venezuelan /r/Causeslegal terms of use
puerto rican	/r/Causes 	puerto rican /r/Causespiano sound
ghanaian	/r/Causes 	ghanaian /r/Causessnowboarding
moroccan	/r/Causes 	moroccan /r/Causeshuman-made organism
somalia	/r/Causes 	somalia /r/Causessyndrome
saudi arabian	/r/Causes 	saudi arabian /r/Causesarabian
syria	/r/Causes 	syria /r/Causessyria
chinese	/r/Causes 	chinese /r/Causescheese paste
pakistani	/r/Causes 	pakistani /r/Causeskaffir
china	/r/Causes 	china /r/Causespasta
india	/r/Causes 	india /r/Causesindia and third editions
irish	/r/Causes 	irish /r/Causesconflict
britain	/r/Causes 	britain /r/Causesvodka sauce
france	/r/Causes 	france /r/Causeshouse
greece	/r/Causes 	greece /r/Causesgeographic border
scotland	/r/Causes 	scotland /r/Causescricket
mexican	/r/Causes 	mexican /r/Causeshuman figure
paraguayan	/r/Causes 	paraguayan /r/Causescouch potato
brazil	/r/Causes 	brazil /r/Causesmusic genre
african	/r/Causes 	african /r/Causesindigenous
eritrean	/r/Causes 	eritrean /r/Causessurgical treatment
sierra leonean	/r/Causes 	sierra leonean /r/Causeseasyl species
africa	/r/Causes 	africa /r/Causeseconomic concept
jordan	/r/Causes 	jordan /r/Causesoccupation
indonesia	/r/Causes 	indonesia /r/Causespop music genre
vietnam	/r/Causes 	vietnam /r/Causesphilosophy in 1803
pakistan	/r/Causes 	pakistan /r/Causesshopper
german	/r/Causes 	german /r/Causescoffee maker
romania	/r/Causes 	romania /r/Causesromantic relationship
brazilian	/r/Causes 	brazilian /r/Causeslegal scholar
ecuadorian	/r/Causes 	ecuadorian /r/Causeseccentric
mexico	/r/Causes 	mexico /r/Causesmexico
puerto rico	/r/Causes 	puerto rico /r/Causesportrait genre
kenyan	/r/Causes 	kenyan /r/Causesrosemary
liberian	/r/Causes 	liberian /r/Causespolitical ideology
cameroonian	/r/Causes 	cameroonian /r/Causescameroon
african americans	/r/Causes 	african americans /r/Causesacademiciate
kenya	/r/Causes 	kenya /r/Causesfish-eating animals
liberia	/r/Causes 	liberia /r/Causeslibertarian ideology
sierra leon	/r/Causes 	sierra leon /r/Causessources of salt
qatari	/r/Causes 	qatari /r/Causescompound food
syrian	/r/Causes 	syrian /r/Causessyrianism
arab	/r/Causes 	arab /r/Causesanimal parts
saudi arabia	/r/Causes 	saudi arabia /r/Causesbuzzage
lebanon	/r/Causes 	lebanon /r/Causesfruit variety
indonesian	/r/Causes 	indonesian /r/Causesindonesian language group
french	/r/Causes 	french /r/Causesfrench music
norwegian	/r/Causes 	norwegian /r/Causesnominal vowel
south africa	/r/Causes 	south africa /r/Causessouth african species
jordanian	/r/Causes 	jordanian /r/Causesviking
korea	/r/Causes 	korea /r/Causesfictional location
singapore	/r/Causes 	singapore /r/Causesmixed martial art
romanian	/r/Causes 	romanian /r/Causesmixture
crimean	/r/Causes 	crimean /r/Causesmilitary rank
native american	/r/Causes 	native american /r/Causesasian
germany	/r/Causes 	germany /r/Causesgeography terminology
ireland	/r/Causes 	ireland /r/Causesmotorway
ecuador	/r/Causes 	ecuador /r/Causesfictional entity
morocco	/r/Causes 	morocco /r/Causesart sculpture
omani	/r/Causes 	omani /r/Causesscholarly article
iranian	/r/Causes 	iranian /r/Causesoccupation
iraqi	/r/Causes 	iraqi /r/Causesjungle music
qatar	/r/Causes 	qatar /r/Causestournament venue
turkey	/r/Causes 	turkey /r/Causesshrub
vietnamese	/r/Causes 	vietnamese /r/Causesvegetarian
nepali	/r/Causes 	nepali /r/Causesnomadic deity
laos	/r/Causes 	laos /r/Causeswomen\'s gymnastics camp
bangladesh	/r/Causes 	bangladesh /r/Causesshooting accident
british	/r/Causes 	british /r/Causesdancing dance
polish	/r/Causes 	polish /r/Causespsychology terminology
greek	/r/Causes 	greek /r/Causesgarden fruit
scottish	/r/Causes 	scottish /r/Causesartistic gymnastics gymnastics
bolivian	/r/Causes 	bolivian /r/Causesmigration
guatemala	/r/Causes 	guatemala /r/Causessamba
ghana	/r/Causes 	ghana /r/Causesgarden seed
cameroon	/r/Causes 	cameroon /r/Causesalpine basin
japanese	/r/Causes 	japanese /r/Causesjapanese family
taiwanese	/r/Causes 	taiwanese /r/Causestaiuna music genre
bengali	/r/Causes 	bengali /r/Causesalpine mountain
nepal	/r/Causes 	nepal /r/Causesceremonies
albanian	/r/Causes 	albanian /r/Causesalbanian language
albania	/r/Causes 	albania /r/Causesgeographical object
columbian	/r/Causes 	columbian /r/Causeshuman figure
peruvian	/r/Causes 	peruvian /r/Causeseastern region
argentian	/r/Causes 	argentian /r/Causesancient title
spain	/r/Causes 	spain /r/Causesspinal diseases
paraguay	/r/Causes 	paraguay /r/Causesparaguay
ethiopian	/r/Causes 	ethiopian /r/Causesethiopian
egyptian	/r/Causes 	egyptian /r/Causesegyptian language style
persian people	/r/Causes 	persian people /r/Causespersian
sweden	/r/Causes 	sweden /r/Causeswelfare state
crimea	/r/Causes 	crimea /r/Causesoccupation
portuguese	/r/Causes 	portuguese /r/Causeslanguage interface
argentina	/r/Causes 	argentina /r/Causesaccumulation
chile	/r/Causes 	chile /r/Causespeanut
cape verdean	/r/Causes 	cape verdean /r/Causesvocal technique
turkish	/r/Causes 	turkish /r/Causesturkish nationalism
yemeni	/r/Causes 	yemeni /r/Causeswhite family
taiwan	/r/Causes 	taiwan /r/Causestaiwan and tea
austrian	/r/Causes 	austrian /r/Causesfemale human
white people	/r/Causes 	white people /r/Causeswhite people
finland	/r/Causes 	finland /r/Causesfortified zone
australia	/r/Causes 	australia /r/Causesmixed martial arts
south african	/r/Causes 	south african /r/Causesarabic
eriteria	/r/Causes 	eriteria /r/Causesparadox
egypt	/r/Causes 	egypt /r/Causesartificial figure
korean	/r/Causes 	korean /r/Causesyun
dutch people	/r/Causes 	dutch people /r/Causescivil war
peru	/r/Causes 	peru /r/Causeschicken allergy
poland	/r/Causes 	poland /r/Causespsychology terminology
chilean	/r/Causes 	chilean /r/Causesscholarly article
columbia	/r/Causes 	columbia /r/Causescricket
bolivia	/r/Causes 	bolivia /r/Causesalbano
laotian	/r/Causes 	laotian /r/Causesliterary genre
lebanese	/r/Causes 	lebanese /r/Causessausage dish
japan	/r/Causes 	japan /r/Causesfictional country
norway	/r/Causes 	norway /r/Causesstreet level
cape verde	/r/Causes 	cape verde /r/Causescolor
portugal	/r/Causes 	portugal /r/Causesgeographical entity
austria	/r/Causes 	austria /r/Causesbruna-eastern region
singaporean	/r/Causes 	singaporean /r/Causesoccupation
netherlands	/r/Causes 	netherlands /r/Causesnatural resource
she	/r/Causes 	she /r/Causesclimbing term
he	/r/Causes 	he /r/Causesfairy figure
hers	/r/Causes 	hers /r/Causesfrigate
him	/r/Causes 	him /r/Causesfemale organism
her	/r/Causes 	her /r/Causesfemale human
herself	/r/Causes 	herself /r/Causesheritage site
himself	/r/Causes 	himself /r/Causesassociate
his	/r/Causes 	his /r/Causessensation
woman	/r/Causes 	woman /r/Causesrole
man	/r/Causes 	man /r/Causesmusical instrument
female	/r/Causes 	female /r/Causesfemale sexual orientation
male	/r/Causes 	male /r/Causescave-dive
lady	/r/Causes 	lady /r/Causeshobby
gentleman	/r/Causes 	gentleman /r/Causeshistorical profession
ladies	/r/Causes 	ladies /r/Causeswomen-cricket
gentlemen	/r/Causes 	gentlemen /r/Causesgentlemen
girl	/r/Causes 	girl /r/Causespersonality test
boy	/r/Causes 	boy /r/Causesboy
sir	/r/Causes 	sir /r/Causesfictional human
ma am	/r/Causes 	ma am /r/Causesmixed martial arts martial arts exhibition
mother	/r/Causes 	mother /r/Causesfather
father	/r/Causes 	father /r/Causesson of
stepmother	/r/Causes 	stepmother /r/Causesyounger
stepfather	/r/Causes 	stepfather /r/Causesbirth family
daughter	/r/Causes 	daughter /r/Causesnurse
son	/r/Causes 	son /r/Causeshockey stick
sister	/r/Causes 	sister /r/Causesfemale human
brother	/r/Causes 	brother /r/Causessocial justice activist
grandmother	/r/Causes 	grandmother /r/Causesgrandchild
grandfather	/r/Causes 	grandfather /r/Causesgrandmother
mommy	/r/Causes 	mommy /r/Causesmommy
daddy	/r/Causes 	daddy /r/Causesdavity
wife	/r/Causes 	wife /r/Causeswife-to-be
husband	/r/Causes 	husband /r/Causessexual relationship
bride	/r/Causes 	bride /r/Causescarpet
groom	/r/Causes 	groom /r/Causestrousers
girlfriend	/r/Causes 	girlfriend /r/Causesassociate
boyfriend	/r/Causes 	boyfriend /r/Causesfriend\'s relationship
schoolgirl	/r/Causes 	schoolgirl /r/Causesgirlship
schoolboy	/r/Causes 	schoolboy /r/Causesmale human
sharia	/r/Causes 	sharia /r/Causesreligious law
jihad	/r/Causes 	jihad /r/Causesjihad
christian	/r/Causes 	christian /r/Causeschristian religion
muslim	/r/Causes 	muslim /r/Causesmuscle
islam	/r/Causes 	islam /r/Causescultural heritage site
hindu	/r/Causes 	hindu /r/Causeschristian religion
mohammed	/r/Causes 	mohammed /r/Causesmahammed
church	/r/Causes 	church /r/Causeschurch building
quran	/r/Causes 	quran /r/Causesbb
bible	/r/Causes 	bible /r/Causesbiblical work
brahmin	/r/Causes 	brahmin /r/Causesbrahmin group
holy trinity	/r/Causes 	holy trinity /r/Causesreligious symbolism
barber	/r/Causes 	barber /r/Causesbarber
coach	/r/Causes 	coach /r/Causescoach family
businessperson	/r/Causes 	businessperson /r/Causestechnical worker
football player	/r/Causes 	football player /r/Causesfootball player
construction worker	/r/Causes 	construction worker /r/Causesfarm worker
manager	/r/Causes 	manager /r/Causesoccupation
ceo	/r/Causes 	ceo /r/Causespale
accountant	/r/Causes 	accountant /r/Causesaccountant
commander	/r/Causes 	commander /r/Causesposition
firefighter	/r/Causes 	firefighter /r/Causesmilitary occupation
mover	/r/Causes 	mover /r/Causesmover
software developer	/r/Causes 	software developer /r/Causessoftware engineer
guard	/r/Causes 	guard /r/Causesguard
baker	/r/Causes 	baker /r/Causesbakers organization
doctor	/r/Causes 	doctor /r/Causesmedical profession
athlete	/r/Causes 	athlete /r/Causesathletics discipline
artist	/r/Causes 	artist /r/Causesfictional character
dancer	/r/Causes 	dancer /r/Causescancer surgeon
mathematician	/r/Causes 	mathematician /r/Causesmusical technique
janitor	/r/Causes 	janitor /r/Causeslegal professional
carpenter	/r/Causes 	carpenter /r/Causesmedical professional
mechanic	/r/Causes 	mechanic /r/Causesmusical composition
actor	/r/Causes 	actor /r/Causesoccupation
handyman	/r/Causes 	handyman /r/Causesoccupation
musician	/r/Causes 	musician /r/Causesmusical style
detective	/r/Causes 	detective /r/Causesdetective technique
politician	/r/Causes 	politician /r/Causesleader
entrepreneur	/r/Causes 	entrepreneur /r/Causesentrepreneur
model	/r/Causes 	model /r/Causesposition
opera singer	/r/Causes 	opera singer /r/Causesposition
chief	/r/Causes 	chief /r/Causeschief
lawyer	/r/Causes 	lawyer /r/Causeslegal practitioner
farmer	/r/Causes 	farmer /r/Causesbirthright
writer	/r/Causes 	writer /r/Causescharacter
librarian	/r/Causes 	librarian /r/Causeslibrarian
army	/r/Causes 	army /r/Causesarmy
real estate developer	/r/Causes 	real estate developer /r/Causesreal estate broker
broker	/r/Causes 	broker /r/Causesasset
scientist	/r/Causes 	scientist /r/Causesphotographer
butcher	/r/Causes 	butcher /r/Causeschess term
electrician	/r/Causes 	electrician /r/Causesfood worker
prosecutor	/r/Causes 	prosecutor /r/Causesprosecutor
banker	/r/Causes 	banker /r/Causesbanker
cook	/r/Causes 	cook /r/Causescooking skill
hairdresser	/r/Causes 	hairdresser /r/Causeshairdresser
prisoner	/r/Causes 	prisoner /r/Causesprisoner
plumber	/r/Causes 	plumber /r/Causesoccupation
attorney	/r/Causes 	attorney /r/Causescounsel
boxer	/r/Causes 	boxer /r/Causesphotographic artist
chess player	/r/Causes 	chess player /r/Causeschess designer
priest	/r/Causes 	priest /r/Causesnursery provider
swimmer	/r/Causes 	swimmer /r/Causesswimmer
tennis player	/r/Causes 	tennis player /r/Causescompetition class
supervisor	/r/Causes 	supervisor /r/Causesoccupation
attendant	/r/Causes 	attendant /r/Causestitle character
housekeeper	/r/Causes 	housekeeper /r/Causessocial worker
maid	/r/Causes 	maid /r/Causeswomen in fiction
producer	/r/Causes 	producer /r/Causesproduction engineer
researcher	/r/Causes 	researcher /r/Causesposition
midwife	/r/Causes 	midwife /r/Causeskinship
judge	/r/Causes 	judge /r/Causesadministrator
umpire	/r/Causes 	umpire /r/Causesfrigate
bartender	/r/Causes 	bartender /r/Causescommission agent
economist	/r/Causes 	economist /r/Causeseconomy professor
physicist	/r/Causes 	physicist /r/Causesphysiological profession
psychologist	/r/Causes 	psychologist /r/Causespsychologist
theologian	/r/Causes 	theologian /r/Causesliterary genre
salesperson	/r/Causes 	salesperson /r/Causesemployee
physician	/r/Causes 	physician /r/Causesphysician
sheriff	/r/Causes 	sheriff /r/Causesposition
cashier	/r/Causes 	cashier /r/Causesfilmmaking occupation
assistant	/r/Causes 	assistant /r/Causesassistant
receptionist	/r/Causes 	receptionist /r/Causeslegal professional
editor	/r/Causes 	editor /r/Causeseditor
engineer	/r/Causes 	engineer /r/Causesengine engine
comedian	/r/Causes 	comedian /r/Causescomedic theme
painter	/r/Causes 	painter /r/Causespainting artist
civil servant	/r/Causes 	civil servant /r/Causesfictional profession
diplomat	/r/Causes 	diplomat /r/Causesjunction
guitarist	/r/Causes 	guitarist /r/Causesguitar musician
linguist	/r/Causes 	linguist /r/Causeshoney-comb
poet	/r/Causes 	poet /r/Causespoetry genre
laborer	/r/Causes 	laborer /r/Causeslabourer
teacher	/r/Causes 	teacher /r/Causesoccupation
delivery man	/r/Causes 	delivery man /r/Causesdelivery agency
realtor	/r/Causes 	realtor /r/Causesoccupation
pilot	/r/Causes 	pilot /r/Causesaircraft rank
professor	/r/Causes 	professor /r/Causesconsultant
chemist	/r/Causes 	chemist /r/Causescombat arts
historian	/r/Causes 	historian /r/Causeshistorical person
pensioner	/r/Causes 	pensioner /r/Causesoccupation
performing artist	/r/Causes 	performing artist /r/Causesconcept artist
singer	/r/Causes 	singer /r/Causesfilm genre
secretary	/r/Causes 	secretary /r/Causeslegislation
auditor	/r/Causes 	auditor /r/Causesauditor
counselor	/r/Causes 	counselor /r/Causescorporate
designer	/r/Causes 	designer /r/Causescraft
soldier	/r/Causes 	soldier /r/Causesmilitary rank
journalist	/r/Causes 	journalist /r/Causesjournalism profession
dentist	/r/Causes 	dentist /r/Causespsychology terminology
analyst	/r/Causes 	analyst /r/Causesexperiment
nurse	/r/Causes 	nurse /r/Causesclinical specialist
tailor	/r/Causes 	tailor /r/Causeslobby
waiter	/r/Causes 	waiter /r/Causesemployee
author	/r/Causes 	author /r/Causesadministrator
architect	/r/Causes 	architect /r/Causesarchitectural style
academic	/r/Causes 	academic /r/Causesacademic
director	/r/Causes 	director /r/Causesposition
illustrator	/r/Causes 	illustrator /r/Causespainting process
clerk	/r/Causes 	clerk /r/Causesclay
policeman	/r/Causes 	policeman /r/Causesoccupation
chef	/r/Causes 	chef /r/Causesoccupation
photographer	/r/Causes 	photographer /r/Causesphotography professional
drawer	/r/Causes 	drawer /r/Causesdrawer
cleaner	/r/Causes 	cleaner /r/Causesmarshal
pharmacist	/r/Causes 	pharmacist /r/Causesoccupation
pianist	/r/Causes 	pianist /r/Causesoccupation
composer	/r/Causes 	composer /r/Causescoordination
handball player	/r/Causes 	handball player /r/Causeshandball position
sociologist	/r/Causes 	sociologist /r/Causesoccupation
african american	/r/CreatedBy 	african american /r/CreatedByabandoned house
armenian	/r/CreatedBy 	armenian /r/CreatedBymilitary rank
persian	/r/CreatedBy 	persian /r/CreatedBymusical arrangement
american	/r/CreatedBy 	american /r/CreatedByamerican
filipino	/r/CreatedBy 	filipino /r/CreatedByfilm style
english	/r/CreatedBy 	english /r/CreatedByscholarly article
norwegian	/r/CreatedBy 	norwegian /r/CreatedBynon-believer
dutch	/r/CreatedBy 	dutch /r/CreatedBydecreasing humidity
israeli	/r/CreatedBy 	israeli /r/CreatedBychess terminology
nigerian	/r/CreatedBy 	nigerian /r/CreatedBynigga
ethiopia	/r/CreatedBy 	ethiopia /r/CreatedByepidemic
europe	/r/CreatedBy 	europe /r/CreatedByarchaeological archive
european	/r/CreatedBy 	european /r/CreatedByceremony
russian	/r/CreatedBy 	russian /r/CreatedByscholarly article
ukraine	/r/CreatedBy 	ukraine /r/CreatedBygreece
sudan	/r/CreatedBy 	sudan /r/CreatedBygreeting
afghanistan	/r/CreatedBy 	afghanistan /r/CreatedBydisaster
iraq	/r/CreatedBy 	iraq /r/CreatedBydiplomatic relationship
yemen	/r/CreatedBy 	yemen /r/CreatedByyemen
ukrainian	/r/CreatedBy 	ukrainian /r/CreatedBysouthern people
russia	/r/CreatedBy 	russia /r/CreatedBysyndicate
italy	/r/CreatedBy 	italy /r/CreatedByphenomenon
somali	/r/CreatedBy 	somali /r/CreatedBycarpool insulation
iran	/r/CreatedBy 	iran /r/CreatedByice rink
afghan	/r/CreatedBy 	afghan /r/CreatedByjoint terrorism
indian	/r/CreatedBy 	indian /r/CreatedByhindian soup
italian	/r/CreatedBy 	italian /r/CreatedByinvoluntary commitment
australian	/r/CreatedBy 	australian /r/CreatedBysouthern hemisphere
spanish	/r/CreatedBy 	spanish /r/CreatedBybilingual
guatemalan	/r/CreatedBy 	guatemalan /r/CreatedByhuman-geography
hispanic	/r/CreatedBy 	hispanic /r/CreatedByanimal disease
venezuela	/r/CreatedBy 	venezuela /r/CreatedBychess term
sudanese	/r/CreatedBy 	sudanese /r/CreatedBysudanese sauce
oman	/r/CreatedBy 	oman /r/CreatedByposition
finnish	/r/CreatedBy 	finnish /r/CreatedBysauna
swedish	/r/CreatedBy 	swedish /r/CreatedByswell
venezuelan	/r/CreatedBy 	venezuelan /r/CreatedByvenezuelan art
puerto rican	/r/CreatedBy 	puerto rican /r/CreatedBygore of rice
ghanaian	/r/CreatedBy 	ghanaian /r/CreatedBycricket
moroccan	/r/CreatedBy 	moroccan /r/CreatedBycanning
somalia	/r/CreatedBy 	somalia /r/CreatedByemergency medicine
saudi arabian	/r/CreatedBy 	saudi arabian /r/CreatedBysaudi
syria	/r/CreatedBy 	syria /r/CreatedBysubstance
chinese	/r/CreatedBy 	chinese /r/CreatedBypink
pakistani	/r/CreatedBy 	pakistani /r/CreatedByterrorism
china	/r/CreatedBy 	china /r/CreatedBycolor
india	/r/CreatedBy 	india /r/CreatedByindigenous culture
irish	/r/CreatedBy 	irish /r/CreatedBygeographical object
britain	/r/CreatedBy 	britain /r/CreatedBychocolate bean
france	/r/CreatedBy 	france /r/CreatedBytheatre venue
greece	/r/CreatedBy 	greece /r/CreatedBygeographic entity
scotland	/r/CreatedBy 	scotland /r/CreatedByflour mill
mexican	/r/CreatedBy 	mexican /r/CreatedByjapanese
paraguayan	/r/CreatedBy 	paraguayan /r/CreatedBychicken in a soup
brazil	/r/CreatedBy 	brazil /r/CreatedByfortification
african	/r/CreatedBy 	african /r/CreatedByacademic
eritrean	/r/CreatedBy 	eritrean /r/CreatedByalcohol resistance status
sierra leonean	/r/CreatedBy 	sierra leonean /r/CreatedBysnacks
africa	/r/CreatedBy 	africa /r/CreatedBygulf syrup
jordan	/r/CreatedBy 	jordan /r/CreatedByclay of clay
indonesia	/r/CreatedBy 	indonesia /r/CreatedByindonesia with multiple languages
vietnam	/r/CreatedBy 	vietnam /r/CreatedBymilitary base
pakistan	/r/CreatedBy 	pakistan /r/CreatedByadministration
german	/r/CreatedBy 	german /r/CreatedByoccupation
romania	/r/CreatedBy 	romania /r/CreatedByromantic fiction
brazilian	/r/CreatedBy 	brazilian /r/CreatedBycabaret
ecuadorian	/r/CreatedBy 	ecuadorian /r/CreatedByelectoral power and reform
mexico	/r/CreatedBy 	mexico /r/CreatedBymystery video game
puerto rico	/r/CreatedBy 	puerto rico /r/CreatedBypoetically modified house
kenyan	/r/CreatedBy 	kenyan /r/CreatedByshade of brown
liberian	/r/CreatedBy 	liberian /r/CreatedBycivil liberties activist
cameroonian	/r/CreatedBy 	cameroonian /r/CreatedBybarrister
african americans	/r/CreatedBy 	african americans /r/CreatedByamusement park
kenya	/r/CreatedBy 	kenya /r/CreatedByshoyuki
liberia	/r/CreatedBy 	liberia /r/CreatedBylibertarian republic
sierra leon	/r/CreatedBy 	sierra leon /r/CreatedBysouthern roe
qatari	/r/CreatedBy 	qatari /r/CreatedByquit
syrian	/r/CreatedBy 	syrian /r/CreatedBysynthesis
arab	/r/CreatedBy 	arab /r/CreatedBydoom
saudi arabia	/r/CreatedBy 	saudi arabia /r/CreatedBychicken tenderloin
lebanon	/r/CreatedBy 	lebanon /r/CreatedByliquor
indonesian	/r/CreatedBy 	indonesian /r/CreatedByindigenous
french	/r/CreatedBy 	french /r/CreatedBycandy coat
norwegian	/r/CreatedBy 	norwegian /r/CreatedBynoble title
south africa	/r/CreatedBy 	south africa /r/CreatedByarma zone
jordanian	/r/CreatedBy 	jordanian /r/CreatedByjazz instrument
korea	/r/CreatedBy 	korea /r/CreatedBysemi-close relation
singapore	/r/CreatedBy 	singapore /r/CreatedBysoutheast migration
romanian	/r/CreatedBy 	romanian /r/CreatedByneuromantic
crimean	/r/CreatedBy 	crimean /r/CreatedBymixture
native american	/r/CreatedBy 	native american /r/CreatedBybiblical archaeology
germany	/r/CreatedBy 	germany /r/CreatedByscholarly article
ireland	/r/CreatedBy 	ireland /r/CreatedBygeographical object
ecuador	/r/CreatedBy 	ecuador /r/CreatedByecuador
morocco	/r/CreatedBy 	morocco /r/CreatedBydinner
omani	/r/CreatedBy 	omani /r/CreatedByhuman interaction
iranian	/r/CreatedBy 	iranian /r/CreatedByin-law
iraqi	/r/CreatedBy 	iraqi /r/CreatedByalley-leaf soup
qatar	/r/CreatedBy 	qatar /r/CreatedBymixed martial arts training
turkey	/r/CreatedBy 	turkey /r/CreatedBycricket ball
vietnamese	/r/CreatedBy 	vietnamese /r/CreatedByvietnamese food and drink
nepali	/r/CreatedBy 	nepali /r/CreatedByindigenous person
laos	/r/CreatedBy 	laos /r/CreatedByplacental anatomy
bangladesh	/r/CreatedBy 	bangladesh /r/CreatedBysurgical complication
british	/r/CreatedBy 	british /r/CreatedBydisco music
polish	/r/CreatedBy 	polish /r/CreatedBypoetry
greek	/r/CreatedBy 	greek /r/CreatedBygospel
scottish	/r/CreatedBy 	scottish /r/CreatedBygroupthink
bolivian	/r/CreatedBy 	bolivian /r/CreatedByfortified tower
guatemala	/r/CreatedBy 	guatemala /r/CreatedByconfined-state prison
ghana	/r/CreatedBy 	ghana /r/CreatedBygarnish
cameroon	/r/CreatedBy 	cameroon /r/CreatedBycamerican football
japanese	/r/CreatedBy 	japanese /r/CreatedByjapanese culture
taiwanese	/r/CreatedBy 	taiwanese /r/CreatedBytaiwanese
bengali	/r/CreatedBy 	bengali /r/CreatedBybengali
nepal	/r/CreatedBy 	nepal /r/CreatedBynepal city
albanian	/r/CreatedBy 	albanian /r/CreatedBycoral song
albania	/r/CreatedBy 	albania /r/CreatedBypapal culture
columbian	/r/CreatedBy 	columbian /r/CreatedBymotorcycle sport
peruvian	/r/CreatedBy 	peruvian /r/CreatedBycultural landscape
argentian	/r/CreatedBy 	argentian /r/CreatedByanatomical form
spain	/r/CreatedBy 	spain /r/CreatedBytissue
paraguay	/r/CreatedBy 	paraguay /r/CreatedByparaguay
ethiopian	/r/CreatedBy 	ethiopian /r/CreatedByhumanoid
egyptian	/r/CreatedBy 	egyptian /r/CreatedByyouth group
persian people	/r/CreatedBy 	persian people /r/CreatedBypersian population
sweden	/r/CreatedBy 	sweden /r/CreatedByslang
crimea	/r/CreatedBy 	crimea /r/CreatedByanimal disease
portuguese	/r/CreatedBy 	portuguese /r/CreatedBysports discipline
argentina	/r/CreatedBy 	argentina /r/CreatedBylaboratory
chile	/r/CreatedBy 	chile /r/CreatedBygarden variety
cape verdean	/r/CreatedBy 	cape verdean /r/CreatedBydancing
turkish	/r/CreatedBy 	turkish /r/CreatedByturkish culture
yemeni	/r/CreatedBy 	yemeni /r/CreatedByyemeni and whites (and blacks)
taiwan	/r/CreatedBy 	taiwan /r/CreatedBytaiye
austrian	/r/CreatedBy 	austrian /r/CreatedByanatomical cluster
white people	/r/CreatedBy 	white people /r/CreatedByethnic people
finland	/r/CreatedBy 	finland /r/CreatedByfinland
australia	/r/CreatedBy 	australia /r/CreatedByinferior part of a central region
south african	/r/CreatedBy 	south african /r/CreatedBysouthfrican
eriteria	/r/CreatedBy 	eriteria /r/CreatedBymusical composition
egypt	/r/CreatedBy 	egypt /r/CreatedBysouthern hemisphere
korean	/r/CreatedBy 	korean /r/CreatedByskimming video game
dutch people	/r/CreatedBy 	dutch people /r/CreatedBysouthern folk
peru	/r/CreatedBy 	peru /r/CreatedBycompared to other
poland	/r/CreatedBy 	poland /r/CreatedByparliamentary initiative
chilean	/r/CreatedBy 	chilean /r/CreatedBycave of chile
columbia	/r/CreatedBy 	columbia /r/CreatedBymixed-sex sport
bolivia	/r/CreatedBy 	bolivia /r/CreatedBycosmopolitan region
laotian	/r/CreatedBy 	laotian /r/CreatedByanarchist
lebanese	/r/CreatedBy 	lebanese /r/CreatedBylebanese juice
japan	/r/CreatedBy 	japan /r/CreatedBynorthern hemisphere
norway	/r/CreatedBy 	norway /r/CreatedBytwenty-ninth note
cape verde	/r/CreatedBy 	cape verde /r/CreatedByfortunace
portugal	/r/CreatedBy 	portugal /r/CreatedBycoconut milk
austria	/r/CreatedBy 	austria /r/CreatedBysouthern half
singaporean	/r/CreatedBy 	singaporean /r/CreatedBysingaporeas
netherlands	/r/CreatedBy 	netherlands /r/CreatedByheritage park
she	/r/CreatedBy 	she /r/CreatedBysoil-feeding pump
he	/r/CreatedBy 	he /r/CreatedBymusic theorist
hers	/r/CreatedBy 	hers /r/CreatedBymotor vehicle service
him	/r/CreatedBy 	him /r/CreatedByphilosophical concept
her	/r/CreatedBy 	her /r/CreatedByfantasy characters
herself	/r/CreatedBy 	herself /r/CreatedBymechanical form
himself	/r/CreatedBy 	himself /r/CreatedBycricket
his	/r/CreatedBy 	his /r/CreatedBymusic degree
woman	/r/CreatedBy 	woman /r/CreatedByfemale person
man	/r/CreatedBy 	man /r/CreatedByoccupation
female	/r/CreatedBy 	female /r/CreatedBygay human
male	/r/CreatedBy 	male /r/CreatedByfemale human
lady	/r/CreatedBy 	lady /r/CreatedBylady
gentleman	/r/CreatedBy 	gentleman /r/CreatedByfortress
ladies	/r/CreatedBy 	ladies /r/CreatedBywomen\'s sports
gentlemen	/r/CreatedBy 	gentlemen /r/CreatedBychef\'s house
girl	/r/CreatedBy 	girl /r/CreatedBysexual intimacy
boy	/r/CreatedBy 	boy /r/CreatedBymixed martial arts wrestling wrestling
sir	/r/CreatedBy 	sir /r/CreatedBymusical ensemble
ma am	/r/CreatedBy 	ma am /r/CreatedBymedical journal
mother	/r/CreatedBy 	mother /r/CreatedBygrandmother
father	/r/CreatedBy 	father /r/CreatedBysocial interaction
stepmother	/r/CreatedBy 	stepmother /r/CreatedBycricket historian
stepfather	/r/CreatedBy 	stepfather /r/CreatedByfather-in-law
daughter	/r/CreatedBy 	daughter /r/CreatedByyoung girl
son	/r/CreatedBy 	son /r/CreatedByhuman figure
sister	/r/CreatedBy 	sister /r/CreatedBysister
brother	/r/CreatedBy 	brother /r/CreatedBybrother-in-law
grandmother	/r/CreatedBy 	grandmother /r/CreatedBygrandfather
grandfather	/r/CreatedBy 	grandfather /r/CreatedBygrandson
mommy	/r/CreatedBy 	mommy /r/CreatedBymusical character
daddy	/r/CreatedBy 	daddy /r/CreatedBydaddy
wife	/r/CreatedBy 	wife /r/CreatedBycamel bone
husband	/r/CreatedBy 	husband /r/CreatedBymale emotion
bride	/r/CreatedBy 	bride /r/CreatedByship type
groom	/r/CreatedBy 	groom /r/CreatedBygarden tree
girlfriend	/r/CreatedBy 	girlfriend /r/CreatedBysportswriter
boyfriend	/r/CreatedBy 	boyfriend /r/CreatedByfamily member
schoolgirl	/r/CreatedBy 	schoolgirl /r/CreatedBygirlhood
schoolboy	/r/CreatedBy 	schoolboy /r/CreatedByboy sexual slavery
sharia	/r/CreatedBy 	sharia /r/CreatedByoccupation
jihad	/r/CreatedBy 	jihad /r/CreatedByjihad
christian	/r/CreatedBy 	christian /r/CreatedBychristian worship
muslim	/r/CreatedBy 	muslim /r/CreatedBymuslim /r/muslim
islam	/r/CreatedBy 	islam /r/CreatedBymusical composition
hindu	/r/CreatedBy 	hindu /r/CreatedByhindu
mohammed	/r/CreatedBy 	mohammed /r/CreatedBymusical work
church	/r/CreatedBy 	church /r/CreatedBychurch building
quran	/r/CreatedBy 	quran /r/CreatedByliterary system
bible	/r/CreatedBy 	bible /r/CreatedBybiblical poetry
brahmin	/r/CreatedBy 	brahmin /r/CreatedBybranch of chemistry
holy trinity	/r/CreatedBy 	holy trinity /r/CreatedBybiblical source
barber	/r/CreatedBy 	barber /r/CreatedBybarber
coach	/r/CreatedBy 	coach /r/CreatedBycoaching
businessperson	/r/CreatedBy 	businessperson /r/CreatedByoccupation
football player	/r/CreatedBy 	football player /r/CreatedBysports coach
construction worker	/r/CreatedBy 	construction worker /r/CreatedByoccupation
manager	/r/CreatedBy 	manager /r/CreatedByperson
ceo	/r/CreatedBy 	ceo /r/CreatedByelectronic code
accountant	/r/CreatedBy 	accountant /r/CreatedByfilm and television industry title
commander	/r/CreatedBy 	commander /r/CreatedBycoordination
firefighter	/r/CreatedBy 	firefighter /r/CreatedByaircraft power utility class
mover	/r/CreatedBy 	mover /r/CreatedByoccupation
software developer	/r/CreatedBy 	software developer /r/CreatedBytechnical person
guard	/r/CreatedBy 	guard /r/CreatedBygarden house
baker	/r/CreatedBy 	baker /r/CreatedBybaker industry
doctor	/r/CreatedBy 	doctor /r/CreatedBydoctor
athlete	/r/CreatedBy 	athlete /r/CreatedByteam leader
artist	/r/CreatedBy 	artist /r/CreatedBygenre of photography
dancer	/r/CreatedBy 	dancer /r/CreatedByaviation surgeon
mathematician	/r/CreatedBy 	mathematician /r/CreatedBymathematical chemistry
janitor	/r/CreatedBy 	janitor /r/CreatedByoccupation
carpenter	/r/CreatedBy 	carpenter /r/CreatedBybicycle maker
mechanic	/r/CreatedBy 	mechanic /r/CreatedBymechanic
actor	/r/CreatedBy 	actor /r/CreatedBymilitary leader
handyman	/r/CreatedBy 	handyman /r/CreatedBypolitical position
musician	/r/CreatedBy 	musician /r/CreatedBymusical group
detective	/r/CreatedBy 	detective /r/CreatedByfilmmaking genre
politician	/r/CreatedBy 	politician /r/CreatedBypolitical activist
entrepreneur	/r/CreatedBy 	entrepreneur /r/CreatedBybusiness entrepreneur
model	/r/CreatedBy 	model /r/CreatedByfigure painting
opera singer	/r/CreatedBy 	opera singer /r/CreatedByfilm crew member
chief	/r/CreatedBy 	chief /r/CreatedByassociate rank
lawyer	/r/CreatedBy 	lawyer /r/CreatedBylawyer
farmer	/r/CreatedBy 	farmer /r/CreatedByeconomic growth
writer	/r/CreatedBy 	writer /r/CreatedByoccupation
librarian	/r/CreatedBy 	librarian /r/CreatedBynaval library
army	/r/CreatedBy 	army /r/CreatedByarmy
real estate developer	/r/CreatedBy 	real estate developer /r/CreatedByoccupation
broker	/r/CreatedBy 	broker /r/CreatedByinvestor
scientist	/r/CreatedBy 	scientist /r/CreatedBypsychology terminology
butcher	/r/CreatedBy 	butcher /r/CreatedByfood coloring
electrician	/r/CreatedBy 	electrician /r/CreatedByarchitectural style
prosecutor	/r/CreatedBy 	prosecutor /r/CreatedByprosecutors
banker	/r/CreatedBy 	banker /r/CreatedBybank supervisor
cook	/r/CreatedBy 	cook /r/CreatedBycooking skill
hairdresser	/r/CreatedBy 	hairdresser /r/CreatedByhairdresser
prisoner	/r/CreatedBy 	prisoner /r/CreatedByprisoner-prisoner
plumber	/r/CreatedBy 	plumber /r/CreatedByfurniture ornament
attorney	/r/CreatedBy 	attorney /r/CreatedBylegal education
boxer	/r/CreatedBy 	boxer /r/CreatedBystreet artist
chess player	/r/CreatedBy 	chess player /r/CreatedByscholarly article
priest	/r/CreatedBy 	priest /r/CreatedByreligious profession
swimmer	/r/CreatedBy 	swimmer /r/CreatedByposition
tennis player	/r/CreatedBy 	tennis player /r/CreatedBytennis club
supervisor	/r/CreatedBy 	supervisor /r/CreatedByemployee
attendant	/r/CreatedBy 	attendant /r/CreatedByattendant
housekeeper	/r/CreatedBy 	housekeeper /r/CreatedByoccupation
maid	/r/CreatedBy 	maid /r/CreatedBymale human
producer	/r/CreatedBy 	producer /r/CreatedByspecialty
researcher	/r/CreatedBy 	researcher /r/CreatedBycinema
midwife	/r/CreatedBy 	midwife /r/CreatedBynatural child
judge	/r/CreatedBy 	judge /r/CreatedByjudgment
umpire	/r/CreatedBy 	umpire /r/CreatedBytool
bartender	/r/CreatedBy 	bartender /r/CreatedByarchitectural style
economist	/r/CreatedBy 	economist /r/CreatedByeconomics terminology
physicist	/r/CreatedBy 	physicist /r/CreatedByphysicist/a/d)physicist
psychologist	/r/CreatedBy 	psychologist /r/CreatedBypsychology terminology
theologian	/r/CreatedBy 	theologian /r/CreatedBytranslator
salesperson	/r/CreatedBy 	salesperson /r/CreatedBymigration
physician	/r/CreatedBy 	physician /r/CreatedByphysician
sheriff	/r/CreatedBy 	sheriff /r/CreatedByposition
cashier	/r/CreatedBy 	cashier /r/CreatedByoccupation
assistant	/r/CreatedBy 	assistant /r/CreatedByassociate
receptionist	/r/CreatedBy 	receptionist /r/CreatedBynarrator
editor	/r/CreatedBy 	editor /r/CreatedByelectoral system
engineer	/r/CreatedBy 	engineer /r/CreatedByengineer
comedian	/r/CreatedBy 	comedian /r/CreatedBycomedian
painter	/r/CreatedBy 	painter /r/CreatedBypainting material
civil servant	/r/CreatedBy 	civil servant /r/CreatedBymilitary officer
diplomat	/r/CreatedBy 	diplomat /r/CreatedBydiplomatic status
guitarist	/r/CreatedBy 	guitarist /r/CreatedByguitarist
linguist	/r/CreatedBy 	linguist /r/CreatedBynatural folk music
poet	/r/CreatedBy 	poet /r/CreatedBychimpo
laborer	/r/CreatedBy 	laborer /r/CreatedByposition
teacher	/r/CreatedBy 	teacher /r/CreatedBystudent
delivery man	/r/CreatedBy 	delivery man /r/CreatedByship operator
realtor	/r/CreatedBy 	realtor /r/CreatedByoccupation
pilot	/r/CreatedBy 	pilot /r/CreatedByship type
professor	/r/CreatedBy 	professor /r/CreatedBytheorist
chemist	/r/CreatedBy 	chemist /r/CreatedByacademic major
historian	/r/CreatedBy 	historian /r/CreatedByhistorical profession
pensioner	/r/CreatedBy 	pensioner /r/CreatedBypublic office
performing artist	/r/CreatedBy 	performing artist /r/CreatedBymusical composition
singer	/r/CreatedBy 	singer /r/CreatedBysinger
secretary	/r/CreatedBy 	secretary /r/CreatedBysecretary
auditor	/r/CreatedBy 	auditor /r/CreatedByauditor
counselor	/r/CreatedBy 	counselor /r/CreatedBydiary
designer	/r/CreatedBy 	designer /r/CreatedBydesigner
soldier	/r/CreatedBy 	soldier /r/CreatedByruler
journalist	/r/CreatedBy 	journalist /r/CreatedByjournalist
dentist	/r/CreatedBy 	dentist /r/CreatedByfoodservice occupation
analyst	/r/CreatedBy 	analyst /r/CreatedByacademic discipline
nurse	/r/CreatedBy 	nurse /r/CreatedBynurse
tailor	/r/CreatedBy 	tailor /r/CreatedByposition
waiter	/r/CreatedBy 	waiter /r/CreatedByposition
author	/r/CreatedBy 	author /r/CreatedByoccupation
architect	/r/CreatedBy 	architect /r/CreatedByarchitectural style
academic	/r/CreatedBy 	academic /r/CreatedByacademic
director	/r/CreatedBy 	director /r/CreatedByposition
illustrator	/r/CreatedBy 	illustrator /r/CreatedBydrawer
clerk	/r/CreatedBy 	clerk /r/CreatedByflute and string instruments
policeman	/r/CreatedBy 	policeman /r/CreatedByoccupation
chef	/r/CreatedBy 	chef /r/CreatedByoccupation
photographer	/r/CreatedBy 	photographer /r/CreatedByphotographer
drawer	/r/CreatedBy 	drawer /r/CreatedByrailroad sign
cleaner	/r/CreatedBy 	cleaner /r/CreatedBytool
pharmacist	/r/CreatedBy 	pharmacist /r/CreatedBybronze
pianist	/r/CreatedBy 	pianist /r/CreatedByoccupation
composer	/r/CreatedBy 	composer /r/CreatedBymusic style
handball player	/r/CreatedBy 	handball player /r/CreatedByoccupation
sociologist	/r/CreatedBy 	sociologist /r/CreatedByacademic
african american	/r/HasPrerequisite 	african american /r/HasPrerequisiteacademic major
armenian	/r/HasPrerequisite 	armenian /r/HasPrerequisitemilitary officer
persian	/r/HasPrerequisite 	persian /r/HasPrerequisitefictional entity
american	/r/HasPrerequisite 	american /r/HasPrerequisiteanatomical structure
filipino	/r/HasPrerequisite 	filipino /r/HasPrerequisitetheatrical character
english	/r/HasPrerequisite 	english /r/HasPrerequisitedefinition
norwegian	/r/HasPrerequisite 	norwegian /r/HasPrerequisiteneighbor
dutch	/r/HasPrerequisite 	dutch /r/HasPrerequisitefood poisoning
israeli	/r/HasPrerequisite 	israeli /r/HasPrerequisiteoccupation
nigerian	/r/HasPrerequisite 	nigerian /r/HasPrerequisitenigga
ethiopia	/r/HasPrerequisite 	ethiopia /r/HasPrerequisitehistorical country complex
europe	/r/HasPrerequisite 	europe /r/HasPrerequisitesemi-permanent country
european	/r/HasPrerequisite 	european /r/HasPrerequisiteeuropean society
russian	/r/HasPrerequisite 	russian /r/HasPrerequisitesubdivision of border
ukraine	/r/HasPrerequisite 	ukraine /r/HasPrerequisiteregion of a single organism
sudan	/r/HasPrerequisite 	sudan /r/HasPrerequisitesnow sports
afghanistan	/r/HasPrerequisite 	afghanistan /r/HasPrerequisitecivilian society
iraq	/r/HasPrerequisite 	iraq /r/HasPrerequisitesalaf
yemen	/r/HasPrerequisite 	yemen /r/HasPrerequisiteseventh cousin
ukrainian	/r/HasPrerequisite 	ukrainian /r/HasPrerequisitecouples
russia	/r/HasPrerequisite 	russia /r/HasPrerequisiterussia
italy	/r/HasPrerequisite 	italy /r/HasPrerequisiteoccupation
somali	/r/HasPrerequisite 	somali /r/HasPrerequisitetobacco industry
iran	/r/HasPrerequisite 	iran /r/HasPrerequisitearchaeological period
afghan	/r/HasPrerequisite 	afghan /r/HasPrerequisitegarden house
indian	/r/HasPrerequisite 	indian /r/HasPrerequisiteindigenous
italian	/r/HasPrerequisite 	italian /r/HasPrerequisiteitalian
australian	/r/HasPrerequisite 	australian /r/HasPrerequisiteacademic
spanish	/r/HasPrerequisite 	spanish /r/HasPrerequisiteship class
guatemalan	/r/HasPrerequisite 	guatemalan /r/HasPrerequisiteguest building
hispanic	/r/HasPrerequisite 	hispanic /r/HasPrerequisitephilosophical concept
venezuela	/r/HasPrerequisite 	venezuela /r/HasPrerequisitecue sport
sudanese	/r/HasPrerequisite 	sudanese /r/HasPrerequisitesudanese soup
oman	/r/HasPrerequisite 	oman /r/HasPrerequisiteoccupation
finnish	/r/HasPrerequisite 	finnish /r/HasPrerequisitelanguage variety
swedish	/r/HasPrerequisite 	swedish /r/HasPrerequisitehuman characteristic
venezuelan	/r/HasPrerequisite 	venezuelan /r/HasPrerequisiteseafood dish
puerto rican	/r/HasPrerequisite 	puerto rican /r/HasPrerequisitechicanery
ghanaian	/r/HasPrerequisite 	ghanaian /r/HasPrerequisitemusical group
moroccan	/r/HasPrerequisite 	moroccan /r/HasPrerequisitehistorical profession
somalia	/r/HasPrerequisite 	somalia /r/HasPrerequisitepopulation loss
saudi arabian	/r/HasPrerequisite 	saudi arabian /r/HasPrerequisitelabor camp
syria	/r/HasPrerequisite 	syria /r/HasPrerequisitesynthetic fiber
chinese	/r/HasPrerequisite 	chinese /r/HasPrerequisitecherry
pakistani	/r/HasPrerequisite 	pakistani /r/HasPrerequisitebb
china	/r/HasPrerequisite 	china /r/HasPrerequisitechef\'s stone
india	/r/HasPrerequisite 	india /r/HasPrerequisiteindigenous culture
irish	/r/HasPrerequisite 	irish /r/HasPrerequisiteanatomical structure
britain	/r/HasPrerequisite 	britain /r/HasPrerequisitefood and drink
france	/r/HasPrerequisite 	france /r/HasPrerequisitecommercial building
greece	/r/HasPrerequisite 	greece /r/HasPrerequisitegreece
scotland	/r/HasPrerequisite 	scotland /r/HasPrerequisitebuilding
mexican	/r/HasPrerequisite 	mexican /r/HasPrerequisitemexican society
paraguayan	/r/HasPrerequisite 	paraguayan /r/HasPrerequisitefictional human
brazil	/r/HasPrerequisite 	brazil /r/HasPrerequisitecuba
african	/r/HasPrerequisite 	african /r/HasPrerequisitecricket
eritrean	/r/HasPrerequisite 	eritrean /r/HasPrerequisitecitation /r/reproductive process
sierra leonean	/r/HasPrerequisite 	sierra leonean /r/HasPrerequisiteleon conservation
africa	/r/HasPrerequisite 	africa /r/HasPrerequisiteagrosy
jordan	/r/HasPrerequisite 	jordan /r/HasPrerequisitecitation
indonesia	/r/HasPrerequisite 	indonesia /r/HasPrerequisiteindigenous country
vietnam	/r/HasPrerequisite 	vietnam /r/HasPrerequisitetourist attraction
pakistan	/r/HasPrerequisite 	pakistan /r/HasPrerequisitesouthern border
german	/r/HasPrerequisite 	german /r/HasPrerequisitecaterpillar
romania	/r/HasPrerequisite 	romania /r/HasPrerequisiteromantic fiction
brazilian	/r/HasPrerequisite 	brazilian /r/HasPrerequisitebrigadier
ecuadorian	/r/HasPrerequisite 	ecuadorian /r/HasPrerequisiteceremonial order
mexico	/r/HasPrerequisite 	mexico /r/HasPrerequisitestreet artist
puerto rico	/r/HasPrerequisite 	puerto rico /r/HasPrerequisitepolitical slogan
kenyan	/r/HasPrerequisite 	kenyan /r/HasPrerequisitechalk
liberian	/r/HasPrerequisite 	liberian /r/HasPrerequisitepolitical activist
cameroonian	/r/HasPrerequisite 	cameroonian /r/HasPrerequisitecameroon
african americans	/r/HasPrerequisite 	african americans /r/HasPrerequisiteoccupation
kenya	/r/HasPrerequisite 	kenya /r/HasPrerequisitescholarly article
liberia	/r/HasPrerequisite 	liberia /r/HasPrerequisitepolitical ideology
sierra leon	/r/HasPrerequisite 	sierra leon /r/HasPrerequisitesled
qatari	/r/HasPrerequisite 	qatari /r/HasPrerequisitenaval aviation
syrian	/r/HasPrerequisite 	syrian /r/HasPrerequisitesyria
arab	/r/HasPrerequisite 	arab /r/HasPrerequisitemilitary helicopter
saudi arabia	/r/HasPrerequisite 	saudi arabia /r/HasPrerequisiteanatomical structure
lebanon	/r/HasPrerequisite 	lebanon /r/HasPrerequisiteanimal medicine
indonesian	/r/HasPrerequisite 	indonesian /r/HasPrerequisiteindonesian culture
french	/r/HasPrerequisite 	french /r/HasPrerequisitemilitary unit unit type-size class
norwegian	/r/HasPrerequisite 	norwegian /r/HasPrerequisitedreadful
south africa	/r/HasPrerequisite 	south africa /r/HasPrerequisitesouth africana
jordanian	/r/HasPrerequisite 	jordanian /r/HasPrerequisitejordanian
korea	/r/HasPrerequisite 	korea /r/HasPrerequisitechina house
singapore	/r/HasPrerequisite 	singapore /r/HasPrerequisitesoutheast
romanian	/r/HasPrerequisite 	romanian /r/HasPrerequisitetheatrical character
crimean	/r/HasPrerequisite 	crimean /r/HasPrerequisiteaccident
native american	/r/HasPrerequisite 	native american /r/HasPrerequisitecocoa dog
germany	/r/HasPrerequisite 	germany /r/HasPrerequisitegraft
ireland	/r/HasPrerequisite 	ireland /r/HasPrerequisitegeographical object
ecuador	/r/HasPrerequisite 	ecuador /r/HasPrerequisiteeccentricity
morocco	/r/HasPrerequisite 	morocco /r/HasPrerequisitelegal concept
omani	/r/HasPrerequisite 	omani /r/HasPrerequisitecricket ball
iranian	/r/HasPrerequisite 	iranian /r/HasPrerequisitefictional organism
iraqi	/r/HasPrerequisite 	iraqi /r/HasPrerequisitemolecular structure
qatar	/r/HasPrerequisite 	qatar /r/HasPrerequisiteship language
turkey	/r/HasPrerequisite 	turkey /r/HasPrerequisitevegetable salad
vietnamese	/r/HasPrerequisite 	vietnamese /r/HasPrerequisitesyrup
nepali	/r/HasPrerequisite 	nepali /r/HasPrerequisitenepalesse
laos	/r/HasPrerequisite 	laos /r/HasPrerequisitelens
bangladesh	/r/HasPrerequisite 	bangladesh /r/HasPrerequisitechess term
british	/r/HasPrerequisite 	british /r/HasPrerequisitecinnamon, brown sugar, and sugar syrup
polish	/r/HasPrerequisite 	polish /r/HasPrerequisitetool
greek	/r/HasPrerequisite 	greek /r/HasPrerequisitegarden stone
scottish	/r/HasPrerequisite 	scottish /r/HasPrerequisitenursery skill
bolivian	/r/HasPrerequisite 	bolivian /r/HasPrerequisitebelong
guatemala	/r/HasPrerequisite 	guatemala /r/HasPrerequisiteart style
ghana	/r/HasPrerequisite 	ghana /r/HasPrerequisitebaked rice
cameroon	/r/HasPrerequisite 	cameroon /r/HasPrerequisitearchaeological structure
japanese	/r/HasPrerequisite 	japanese /r/HasPrerequisitehiking permit
taiwanese	/r/HasPrerequisite 	taiwanese /r/HasPrerequisitenorthern hemisphere
bengali	/r/HasPrerequisite 	bengali /r/HasPrerequisitebengali
nepal	/r/HasPrerequisite 	nepal /r/HasPrerequisitecattle season
albanian	/r/HasPrerequisite 	albanian /r/HasPrerequisitealbania
albania	/r/HasPrerequisite 	albania /r/HasPrerequisitecoconut sugar
columbian	/r/HasPrerequisite 	columbian /r/HasPrerequisitenatural geographic entity
peruvian	/r/HasPrerequisite 	peruvian /r/HasPrerequisitesuburbs
argentian	/r/HasPrerequisite 	argentian /r/HasPrerequisitemilitary rank
spain	/r/HasPrerequisite 	spain /r/HasPrerequisitemusical figure
paraguay	/r/HasPrerequisite 	paraguay /r/HasPrerequisiteparalympic group
ethiopian	/r/HasPrerequisite 	ethiopian /r/HasPrerequisitegeographical entity
egyptian	/r/HasPrerequisite 	egyptian /r/HasPrerequisitetranslator
persian people	/r/HasPrerequisite 	persian people /r/HasPrerequisitepsychology terminology
sweden	/r/HasPrerequisite 	sweden /r/HasPrerequisiteswag
crimea	/r/HasPrerequisite 	crimea /r/HasPrerequisitecrime
portuguese	/r/HasPrerequisite 	portuguese /r/HasPrerequisitecaching port
argentina	/r/HasPrerequisite 	argentina /r/HasPrerequisitesouthern hemisphere
chile	/r/HasPrerequisite 	chile /r/HasPrerequisitechile dish
cape verdean	/r/HasPrerequisite 	cape verdean /r/HasPrerequisiteverdean
turkish	/r/HasPrerequisite 	turkish /r/HasPrerequisiteturkish identity
yemeni	/r/HasPrerequisite 	yemeni /r/HasPrerequisitemuslimi
taiwan	/r/HasPrerequisite 	taiwan /r/HasPrerequisitetaiwan farming
austrian	/r/HasPrerequisite 	austrian /r/HasPrerequisitereligious figure
white people	/r/HasPrerequisite 	white people /r/HasPrerequisiteethnic group
finland	/r/HasPrerequisite 	finland /r/HasPrerequisitewater reservoir
australia	/r/HasPrerequisite 	australia /r/HasPrerequisitedesert
south african	/r/HasPrerequisite 	south african /r/HasPrerequisitegroup of organisms known by one particular common name
eriteria	/r/HasPrerequisite 	eriteria /r/HasPrerequisitegroup-type algorithm
egypt	/r/HasPrerequisite 	egypt /r/HasPrerequisiteneighborhood
korean	/r/HasPrerequisite 	korean /r/HasPrerequisitekorean food
dutch people	/r/HasPrerequisite 	dutch people /r/HasPrerequisitee-commerce
peru	/r/HasPrerequisite 	peru /r/HasPrerequisitegenre of living organism
poland	/r/HasPrerequisite 	poland /r/HasPrerequisitefood poisoning
chilean	/r/HasPrerequisite 	chilean /r/HasPrerequisitechilean culture
columbia	/r/HasPrerequisite 	columbia /r/HasPrerequisitegeographic region
bolivia	/r/HasPrerequisite 	bolivia /r/HasPrerequisitecompound flour
laotian	/r/HasPrerequisite 	laotian /r/HasPrerequisitefemale human
lebanese	/r/HasPrerequisite 	lebanese /r/HasPrerequisitefish dish
japan	/r/HasPrerequisite 	japan /r/HasPrerequisitenaval city
norway	/r/HasPrerequisite 	norway /r/HasPrerequisitenorthern hemisphere
cape verde	/r/HasPrerequisite 	cape verde /r/HasPrerequisitemixed martial arts form
portugal	/r/HasPrerequisite 	portugal /r/HasPrerequisiteportrait portrait
austria	/r/HasPrerequisite 	austria /r/HasPrerequisitenorthern route
singaporean	/r/HasPrerequisite 	singaporean /r/HasPrerequisitesoutheast Asia
netherlands	/r/HasPrerequisite 	netherlands /r/HasPrerequisiteheritage site
she	/r/HasPrerequisite 	she /r/HasPrerequisitemusical ensemble
he	/r/HasPrerequisite 	he /r/HasPrerequisitesport discipline
hers	/r/HasPrerequisite 	hers /r/HasPrerequisitejoint
him	/r/HasPrerequisite 	him /r/HasPrerequisiteoccupation
her	/r/HasPrerequisite 	her /r/HasPrerequisitenoble title
herself	/r/HasPrerequisite 	herself /r/HasPrerequisitefemale organ
himself	/r/HasPrerequisite 	himself /r/HasPrerequisitemechanism
his	/r/HasPrerequisite 	his /r/HasPrerequisitecandy beverage
woman	/r/HasPrerequisite 	woman /r/HasPrerequisitefemale human
man	/r/HasPrerequisite 	man /r/HasPrerequisitefictional deity
female	/r/HasPrerequisite 	female /r/HasPrerequisitefemale
male	/r/HasPrerequisite 	male /r/HasPrerequisitesexual orientation
lady	/r/HasPrerequisite 	lady /r/HasPrerequisitelady
gentleman	/r/HasPrerequisite 	gentleman /r/HasPrerequisiteoccupation
ladies	/r/HasPrerequisite 	ladies /r/HasPrerequisitetotality
gentlemen	/r/HasPrerequisite 	gentlemen /r/HasPrerequisitegentleman
girl	/r/HasPrerequisite 	girl /r/HasPrerequisitefictional human
boy	/r/HasPrerequisite 	boy /r/HasPrerequisiteship type
sir	/r/HasPrerequisite 	sir /r/HasPrerequisitesir
ma am	/r/HasPrerequisite 	ma am /r/HasPrerequisitepsychology terminology
mother	/r/HasPrerequisite 	mother /r/HasPrerequisitekinship
father	/r/HasPrerequisite 	father /r/HasPrerequisitekinship
stepmother	/r/HasPrerequisite 	stepmother /r/HasPrerequisiteproprietor
stepfather	/r/HasPrerequisite 	stepfather /r/HasPrerequisitekinship
daughter	/r/HasPrerequisite 	daughter /r/HasPrerequisitemale human
son	/r/HasPrerequisite 	son /r/HasPrerequisitefemale human
sister	/r/HasPrerequisite 	sister /r/HasPrerequisitebrother
brother	/r/HasPrerequisite 	brother /r/HasPrerequisiteassociate
grandmother	/r/HasPrerequisite 	grandmother /r/HasPrerequisitefather
grandfather	/r/HasPrerequisite 	grandfather /r/HasPrerequisitegrandfather or descendent
mommy	/r/HasPrerequisite 	mommy /r/HasPrerequisitecute
daddy	/r/HasPrerequisite 	daddy /r/HasPrerequisitemoody
wife	/r/HasPrerequisite 	wife /r/HasPrerequisitefemale human
husband	/r/HasPrerequisite 	husband /r/HasPrerequisitehusband
bride	/r/HasPrerequisite 	bride /r/HasPrerequisiteclimbing equipment
groom	/r/HasPrerequisite 	groom /r/HasPrerequisitegroom
girlfriend	/r/HasPrerequisite 	girlfriend /r/HasPrerequisiterole model
boyfriend	/r/HasPrerequisite 	boyfriend /r/HasPrerequisitesister
schoolgirl	/r/HasPrerequisite 	schoolgirl /r/HasPrerequisitefilm star
schoolboy	/r/HasPrerequisite 	schoolboy /r/HasPrerequisiteboys and girls\'s sports
sharia	/r/HasPrerequisite 	sharia /r/HasPrerequisitesharia
jihad	/r/HasPrerequisite 	jihad /r/HasPrerequisitescholarly article
christian	/r/HasPrerequisite 	christian /r/HasPrerequisitefictional entity
muslim	/r/HasPrerequisite 	muslim /r/HasPrerequisitemusical composition
islam	/r/HasPrerequisite 	islam /r/HasPrerequisiteammunition
hindu	/r/HasPrerequisite 	hindu /r/HasPrerequisiteslam
mohammed	/r/HasPrerequisite 	mohammed /r/HasPrerequisitemedical research
church	/r/HasPrerequisite 	church /r/HasPrerequisitehouse
quran	/r/HasPrerequisite 	quran /r/HasPrerequisitemusical instrument
bible	/r/HasPrerequisite 	bible /r/HasPrerequisitebiblical education
brahmin	/r/HasPrerequisite 	brahmin /r/HasPrerequisitemusical group
holy trinity	/r/HasPrerequisite 	holy trinity /r/HasPrerequisitetrinity
barber	/r/HasPrerequisite 	barber /r/HasPrerequisitebronze
coach	/r/HasPrerequisite 	coach /r/HasPrerequisitefictional automobile
businessperson	/r/HasPrerequisite 	businessperson /r/HasPrerequisitepersonation
football player	/r/HasPrerequisite 	football player /r/HasPrerequisitesports discipline
construction worker	/r/HasPrerequisite 	construction worker /r/HasPrerequisiteprocess worker
manager	/r/HasPrerequisite 	manager /r/HasPrerequisiteoccupation
ceo	/r/HasPrerequisite 	ceo /r/HasPrerequisiteclimbing
accountant	/r/HasPrerequisite 	accountant /r/HasPrerequisiteaccountant
commander	/r/HasPrerequisite 	commander /r/HasPrerequisitemilitary rank
firefighter	/r/HasPrerequisite 	firefighter /r/HasPrerequisiteaircraft functional class
mover	/r/HasPrerequisite 	mover /r/HasPrerequisitemusical composition
software developer	/r/HasPrerequisite 	software developer /r/HasPrerequisitesoftware engineer
guard	/r/HasPrerequisite 	guard /r/HasPrerequisitecombat equipment
baker	/r/HasPrerequisite 	baker /r/HasPrerequisitefood ingredient
doctor	/r/HasPrerequisite 	doctor /r/HasPrerequisitelegal name
athlete	/r/HasPrerequisite 	athlete /r/HasPrerequisiteathlete
artist	/r/HasPrerequisite 	artist /r/HasPrerequisiterole
dancer	/r/HasPrerequisite 	dancer /r/HasPrerequisitedental physician
mathematician	/r/HasPrerequisite 	mathematician /r/HasPrerequisitegeologist
janitor	/r/HasPrerequisite 	janitor /r/HasPrerequisitenarrative profession
carpenter	/r/HasPrerequisite 	carpenter /r/HasPrerequisitehead
mechanic	/r/HasPrerequisite 	mechanic /r/HasPrerequisiteoccupation
actor	/r/HasPrerequisite 	actor /r/HasPrerequisiteposition
handyman	/r/HasPrerequisite 	handyman /r/HasPrerequisitehouse officer
musician	/r/HasPrerequisite 	musician /r/HasPrerequisitemusical composition
detective	/r/HasPrerequisite 	detective /r/HasPrerequisitedetective
politician	/r/HasPrerequisite 	politician /r/HasPrerequisitepolitical activist
entrepreneur	/r/HasPrerequisite 	entrepreneur /r/HasPrerequisiteoccupation
model	/r/HasPrerequisite 	model /r/HasPrerequisiteconstruction
opera singer	/r/HasPrerequisite 	opera singer /r/HasPrerequisiteperformer
chief	/r/HasPrerequisite 	chief /r/HasPrerequisiteofficial
lawyer	/r/HasPrerequisite 	lawyer /r/HasPrerequisitevice officer
farmer	/r/HasPrerequisite 	farmer /r/HasPrerequisitegardenian
writer	/r/HasPrerequisite 	writer /r/HasPrerequisiteeditor
librarian	/r/HasPrerequisite 	librarian /r/HasPrerequisitecitizen
army	/r/HasPrerequisite 	army /r/HasPrerequisitearmed group
real estate developer	/r/HasPrerequisite 	real estate developer /r/HasPrerequisiteoccupation
broker	/r/HasPrerequisite 	broker /r/HasPrerequisiteship type
scientist	/r/HasPrerequisite 	scientist /r/HasPrerequisiteoccupation
butcher	/r/HasPrerequisite 	butcher /r/HasPrerequisitefictional mammal
electrician	/r/HasPrerequisite 	electrician /r/HasPrerequisitemusician
prosecutor	/r/HasPrerequisite 	prosecutor /r/HasPrerequisitelegal person
banker	/r/HasPrerequisite 	banker /r/HasPrerequisitecommercial bank
cook	/r/HasPrerequisite 	cook /r/HasPrerequisiteshrimp dish
hairdresser	/r/HasPrerequisite 	hairdresser /r/HasPrerequisitedresser
prisoner	/r/HasPrerequisite 	prisoner /r/HasPrerequisiteprisoner
plumber	/r/HasPrerequisite 	plumber /r/HasPrerequisitesieve
attorney	/r/HasPrerequisite 	attorney /r/HasPrerequisiteadvanced legal education
boxer	/r/HasPrerequisite 	boxer /r/HasPrerequisitesausage maker
chess player	/r/HasPrerequisite 	chess player /r/HasPrerequisiteassociate player
priest	/r/HasPrerequisite 	priest /r/HasPrerequisiteparent
swimmer	/r/HasPrerequisite 	swimmer /r/HasPrerequisiteswimmer
tennis player	/r/HasPrerequisite 	tennis player /r/HasPrerequisitefield position
supervisor	/r/HasPrerequisite 	supervisor /r/HasPrerequisitesupervision
attendant	/r/HasPrerequisite 	attendant /r/HasPrerequisitecounseling
housekeeper	/r/HasPrerequisite 	housekeeper /r/HasPrerequisitecookies industry
maid	/r/HasPrerequisite 	maid /r/HasPrerequisitecharacter
producer	/r/HasPrerequisite 	producer /r/HasPrerequisiteproducer
researcher	/r/HasPrerequisite 	researcher /r/HasPrerequisiteoperating system
midwife	/r/HasPrerequisite 	midwife /r/HasPrerequisitesister
judge	/r/HasPrerequisite 	judge /r/HasPrerequisitecompetition assessment
umpire	/r/HasPrerequisite 	umpire /r/HasPrerequisitehump
bartender	/r/HasPrerequisite 	bartender /r/HasPrerequisiteoccupation
economist	/r/HasPrerequisite 	economist /r/HasPrerequisitespecialty
physicist	/r/HasPrerequisite 	physicist /r/HasPrerequisitescholarly article
psychologist	/r/HasPrerequisite 	psychologist /r/HasPrerequisitehealth analyst
theologian	/r/HasPrerequisite 	theologian /r/HasPrerequisiteoccupation
salesperson	/r/HasPrerequisite 	salesperson /r/HasPrerequisiteaccountant
physician	/r/HasPrerequisite 	physician /r/HasPrerequisitehealth professional
sheriff	/r/HasPrerequisite 	sheriff /r/HasPrerequisitecounseling
cashier	/r/HasPrerequisite 	cashier /r/HasPrerequisiteposition
assistant	/r/HasPrerequisite 	assistant /r/HasPrerequisitemilitary rank
receptionist	/r/HasPrerequisite 	receptionist /r/HasPrerequisitereceptionist
editor	/r/HasPrerequisite 	editor /r/HasPrerequisiteeditor
engineer	/r/HasPrerequisite 	engineer /r/HasPrerequisiteengineer
comedian	/r/HasPrerequisite 	comedian /r/HasPrerequisitecomedian
painter	/r/HasPrerequisite 	painter /r/HasPrerequisitepainting material
civil servant	/r/HasPrerequisite 	civil servant /r/HasPrerequisiteposition
diplomat	/r/HasPrerequisite 	diplomat /r/HasPrerequisitediplomacy
guitarist	/r/HasPrerequisite 	guitarist /r/HasPrerequisitemusic term
linguist	/r/HasPrerequisite 	linguist /r/HasPrerequisiteoccupation
poet	/r/HasPrerequisite 	poet /r/HasPrerequisitepoet
laborer	/r/HasPrerequisite 	laborer /r/HasPrerequisiteeconomic position
teacher	/r/HasPrerequisite 	teacher /r/HasPrerequisiteteacher
delivery man	/r/HasPrerequisite 	delivery man /r/HasPrerequisiteperson
realtor	/r/HasPrerequisite 	realtor /r/HasPrerequisiteposition
pilot	/r/HasPrerequisite 	pilot /r/HasPrerequisitefictional character
professor	/r/HasPrerequisite 	professor /r/HasPrerequisitefaculty
chemist	/r/HasPrerequisite 	chemist /r/HasPrerequisitefictional human
historian	/r/HasPrerequisite 	historian /r/HasPrerequisitehistorical genre
pensioner	/r/HasPrerequisite 	pensioner /r/HasPrerequisitepassenger
performing artist	/r/HasPrerequisite 	performing artist /r/HasPrerequisiteformal scientist
singer	/r/HasPrerequisite 	singer /r/HasPrerequisitehumanoid
secretary	/r/HasPrerequisite 	secretary /r/HasPrerequisitetitle criterion
auditor	/r/HasPrerequisite 	auditor /r/HasPrerequisitefilm industry office
counselor	/r/HasPrerequisite 	counselor /r/HasPrerequisitelegal professional
designer	/r/HasPrerequisite 	designer /r/HasPrerequisitedesigner
soldier	/r/HasPrerequisite 	soldier /r/HasPrerequisiteoccupation
journalist	/r/HasPrerequisite 	journalist /r/HasPrerequisitepublicity specialist
dentist	/r/HasPrerequisite 	dentist /r/HasPrerequisitenursing technician
analyst	/r/HasPrerequisite 	analyst /r/HasPrerequisiteanalyst
nurse	/r/HasPrerequisite 	nurse /r/HasPrerequisitemural
tailor	/r/HasPrerequisite 	tailor /r/HasPrerequisiteposition
waiter	/r/HasPrerequisite 	waiter /r/HasPrerequisitemilitary unit
author	/r/HasPrerequisite 	author /r/HasPrerequisiteauthorial authority
architect	/r/HasPrerequisite 	architect /r/HasPrerequisitearchitectural designer
academic	/r/HasPrerequisite 	academic /r/HasPrerequisiteacademic
director	/r/HasPrerequisite 	director /r/HasPrerequisiteposition
illustrator	/r/HasPrerequisite 	illustrator /r/HasPrerequisiteengineer
clerk	/r/HasPrerequisite 	clerk /r/HasPrerequisitecompound substance
policeman	/r/HasPrerequisite 	policeman /r/HasPrerequisiteoccupation
chef	/r/HasPrerequisite 	chef /r/HasPrerequisitechef
photographer	/r/HasPrerequisite 	photographer /r/HasPrerequisitephotographer
drawer	/r/HasPrerequisite 	drawer /r/HasPrerequisitecraft
cleaner	/r/HasPrerequisite 	cleaner /r/HasPrerequisitemachine tool
pharmacist	/r/HasPrerequisite 	pharmacist /r/HasPrerequisiteoccupation
pianist	/r/HasPrerequisite 	pianist /r/HasPrerequisiteposition
composer	/r/HasPrerequisite 	composer /r/HasPrerequisiteprofessional
handball player	/r/HasPrerequisite 	handball player /r/HasPrerequisiteball player
sociologist	/r/HasPrerequisite 	sociologist /r/HasPrerequisiteacademic
